cve_edo,Municipio,PD1,PD2,PD3,Total
1, AGUASCALIENTES,560,396,5886,6842
1, ASIENTOS,77,3,15,95
1, CALVILLO,65,14,8,87
1, COSIO,4,9,1,14
1, JESUS MARIA,4,18,90,112
1, PABELLON DE ARTEAG,19,6,29,54
1, RINCON DE ROMOS,6,26,15,47
1, SAN JOSE DE GRACIA,5,0,0,5
1, SAN FRANCISCO DE L,630,376,3,1009
1, TEPEZALA,1,1,1,3
1, EL LLANO,503,1,0,504
2, ENSENADA,308,6,189,503
2, MEXICALI,3218,1362,2101,6681
2, TECATE,0,6,3,9
3," LOS CABOS, B.C.S.",551,218,28,797
3, COMONDU,43,481,35,559
3, MULEGE,873,43,19,935
3, LA PAZ,441,158,148,747
3, LORETO,0,52,4,56
4, CALKINI,549,246,1,796
4, CAMPECHE,543,52,68,663
4, CARMEN,476,19,84,579
4, CHAMPOTON,390,769,21,1180
4, ESCARCEGA,493,781,2,1276
4, HECELCHAKAN,224,52,3,279
4, CANDELARIA,10,4,4,18
4, HOPELCHEN,990,318,49,1357
4, PALIZADA,48,4,35,87
4, CALAKMUL,0,4,0,4
4, TENABO,91,11,3,105
7, ACACOYAGUA,0,0,0,0
7, ACALA,81,12,0,93
7, ACAPETAGUA,93,0,12,105
7, ALTAMIRANO,0,0,0,0
7, AMATAN,0,2,1,3
7, AMATENANGO DE LA F,489,10,0,499
7, AMATENANGO DEL VAL,0,0,0,0
7, JALTENANGO,1289,126,3,1418
7, ARRIAGA,33,3,1,37
7, BELLA VISTA,61,12,0,73
7, BERRIOZABAL,145,23,0,168
7, BOCHIL,526,5,0,531
7, EL BOSQUE,0,0,0,0
7, CACAHOTAN,511,1,2,514
7, PLAYAS DE CATAZAJA,382,2,0,384
7, CHALCHIHUITAN,0,0,0,0
7, CHAMULA,0,0,0,0
7, CHAPULTENANGO,4,3,1,8
7, CHIAPA DE CORZO,2143,303,4,2450
7, CHIAPILLA,0,0,0,0
7, CHICOASEN,0,0,0,0
7, CHICOMUSELO,555,52,6,613
7, CHILON,289,1,1,291
7, CINTALAPA,3017,337,10,3364
7, COMITAN DE DOMINGU,2081,417,30,2528
7, LA CONCORDIA,2657,16,30,2703
7, COPAINALA,1,8,0,9
7, ESCUINTLA,829,24,5,858
7, FRANCISCO LEON,0,0,0,0
7, FRONTERA COMALAPA,6656,471,3,7130
7, FRONTERA HGO.,98,0,0,98
7, HUEHUETAN,561,5,17,583
7, HUITIUPAN,0,0,0,0
7, HUIXTLA,3408,1135,0,4543
7, LA INDEPENDENCIA,1160,290,0,1450
7, IXHUATAN,2,45,0,47
7, IXTACOMITAN,3,0,2,5
7, IXTAPA,12,0,0,12
7, JIQUIPILAS,375,22,5,402
7, JITOTOL,34,0,0,34
7, JUAREZ,0,2,13,15
7, LA LIBERTAD,11,0,1,12
7, MAPASTEPEC,2041,318,2,2361
7, LAS MARGARITAS,0,12,0,12
7, MAZATAN,273,33,18,324
7, METAPA,0,0,0,0
7, MOTOZINTLA,1685,2,48,1735
7, OCOSINGO,2309,4,0,2313
7, OCOZOCOAUTLA DE ES,166,245,2,413
7, OSTUACAN,33,7,1,41
7, OSUMACINTA,0,0,0,0
7, PALENQUE,6389,371,603,7363
7, PANTELHO,0,0,0,0
7, PANTEPEC,0,0,0,0
7, PICHUCALCO,22,6,3,31
7, PIJIJIAPAN,5,2,3,10
7, PUEBLO NUEVO COMAL,178,2,10,190
7, PUEBLO NUEVO SOLIS,1,0,0,1
7, RAYON,0,0,0,0
7, REFORMA,0,3,57,60
7, SABANILLAS,0,0,0,0
7, SALTO DEL AGUA,187,46,2,235
7, SAN CRISTOBAL DE L,0,20,1,21
7, SAN FERNANDO,314,37,0,351
7, SIMOJOVEL DE ALLEN,70,0,0,70
7, SOCOLTENANGO,3383,2,2,3387
7, SOLUSUCHIAPA,2,3,1,6
7, SOYALO,0,0,0,0
7, SUCHIAPA,295,120,1,416
7, SUCHIATE,119,96,12,227
7, SUNUAPA,0,0,1,1
7, TAPACHULA,3440,825,284,4549
7, TAPALAPA,0,0,0,0
7, TAPILULA,2,1,0,3
7, TECPATAN,514,26,2,542
7, TENEJAPA,0,1,0,1
7, TEOPISCA,0,0,0,0
7, TILA,50,0,0,50
7, TONALA,4785,2249,17,7051
7, TOTOLAPA,0,0,0,0
7, LA TRINITARIA,107,26,0,133
7, TUMBALA,7,1,0,8
7, TUXTLA GUTIERREZ,7306,2365,379,10050
7, TUXTLA CHICO,16,0,0,16
7, TUZANTAN,510,2,0,512
7, TZIMOL,0,0,0,0
7, UNION JUAREZ,92,0,0,92
7, VENUSTIANO CARRANZ,963,353,2,1318
7, ANGEL A CORZO (JAL,2051,15,6,2072
7, VILLA FLORES,14318,1524,8,15850
7, YAJALON,224,366,29,619
7, SAN LUCAS (EL ZAPO,0,0,0,0
7, ZINACANTAN,0,0,0,0
8, ALDAMA,0,6,28,34
8, ALLENDE,1,6,6,13
8, ASCENCION,309,2,18,329
8, BACHINIVA,0,0,1,1
8, BALLEZA,0,7,2,9
8, BOCOYNA,0,0,0,0
8, BUENAVENTURA,0,161,29,190
8, CAMARGO,35,52,40,127
8, CASAS GRANDES,0,0,48,48
8, CHIHUAHUA,3246,346,258,3850
8, CHINIPAS,0,3,0,3
8, COYAME,0,0,1,1
8, LA CRUZ,0,0,0,0
8, CUAUHTEMOC,468,2677,1111,4256
8, CUSIHUIRIACHIC,0,0,13,13
8, DELICIAS,442,1963,364,2769
8, GALEANA,0,0,0,0
8, GENERAL FRIAS,40,0,0,40
8, GOMEZ FARIAS,0,0,0,0
8, GRAN MORELOS,0,0,0,0
8, GUACHOCHI,453,0,1,454
8, GUADALUPE Y CALVO,0,0,14,14
8, GUERRERO,0,6,10,16
8, HIDALGO DEL PARRAL,209,15,100,324
8, HUEJOTITLAN,0,0,1,1
8, IGNACIO ZARAGOZA,0,0,0,0
8, JANOS,0,0,71,71
8, JIMENEZ,0,114,64,178
8, JUAREZ,1,62,218,281
8, JULIMES,23,33,0,56
8, MADERA,0,28,1,29
8, MANUEL BENAVIDES,0,0,1,1
8, MATACHIC,0,0,0,0
8, MEOQUI,21,73,51,145
8, NAMIQUIPA,0,72,14,86
8, NUEVO CASAS GRANDE,216,63,201,480
8, OJINAGA,9,29,172,210
8, PRAXEDIS G GUERRER,0,0,6,6
8, RIVA PALACIO,0,0,0,0
8, ROSALES,11,24,3,38
8, SAN FRANCISCO DE B,0,0,5,5
8, SAN FRANCISCO DE C,0,2,4,6
8, SAN FRANCISCO DEL ,0,0,0,0
8, SANTA BARBARA,184,0,1,185
8, SATEVO,0,0,10,10
8, SAUCILLO,45,98,26,169
8, TEMOSACHIC,0,0,6,6
8, AHUMADA,2,0,14,16
8, CORONADO,5,9,0,14
8, LOPEZ,1,2,0,3
8, MATAMOROS,0,8,2,10
8, VALLE DE ZARAGOZA,0,0,4,4
5, ABASOLO,0,0,2,2
5, ACUNA,0,0,0,0
5, ALLENDE,0,0,0,0
5, ARTEAGA,2,5,61,68
5, CANDELA,0,0,0,0
5, CASTANOS,0,4,0,4
5, CUATROCIENEGAS,0,0,0,0
5, GALEANA,0,0,270,270
5, GENERAL CEPEDA,55,3,2,60
5, JIMENEZ,0,0,0,0
5, MATAMOROS,200,11,44,255
5, MONCLOVA,0,5,0,5
5, MORELOS,0,2,0,2
5, MUZQUIZ,0,180,13,193
5, NADADORES,0,0,0,0
5, OCAMPO,0,0,0,0
5, PARRAS,35,4,4,43
5, PIEDRAS NEGRAS,0,0,0,0
5, RAMOS ARIZPE,3,0,248,251
5, SACRAMENTO,0,0,0,0
5, SALTILLO,32,10,122,164
5, SAN BUENAVENTURA,0,10,1,11
5, SAN JUAN DE SABINA,0,0,2,2
5, TORREON,15818,509,549,16876
5, FRONTERA,0,0,0,0
5, VILLA UNION,0,0,2,2
5, ZARAGOZA,0,0,1,1
6, ARMERIA,576,0,0,576
6, COLIMA,1136,93,198,1427
6, COMALA,1277,0,0,1277
6, COQUIMATLAN,81,1,0,82
6, CUAUHTEMOC,7781,1887,412,10080
6, IXTLAHUACAN,6,0,0,6
6, MANZANILLO,429,34,119,582
6, MINATITLAN,0,0,2,2
6, TECOMAN,964,44,60,1068
6, VILLA DE ALVAREZ,0,0,12,12
9, AZCAPOTZALCO,0,0,127,127
9, MIGUEL HIDALGO,0,0,72,72
9, COYOACAN,0,0,12,12
9, CUAJIMALPA DE MORE,0,0,134,134
9, GUSTAVO A MADERO,0,8,7,15
9, IXTACALCO,0,0,6,6
9, IZTAPALAPA,0,0,165,165
9, CUAUHTEMOC,0,0,52,52
9, MILPA ALTA,1,723,0,724
9, ALVARO OBREGON,0,0,70,70
9, BENITO JUAREZ,0,0,80,80
9, TLAHUAC,0,0,8,8
9, TLALPAN,0,0,35,35
9, XOCHIMILCO,0,249,2,251
10, FRANCISCO I MADERO,0,1,50,51
10, CANATLAN,10,9,9,28
10, CANELAS,0,2,2,4
10, CONETO DE COMONFOR,0,1,0,1
10, SAN PEDRO,0,0,2,2
10, CUENCAME,4,3,6,13
10, VIESCA,0,0,0,0
10, DURANGO,28198,120,299,28617
10, GENERAL SIMON BOLI,0,0,1,1
10, GOMEZ PALACIO,199,159,1310,1668
10, GUADALUPE VICTORIA,173,39,63,275
10, GUANACEVI,0,12,3,15
10, HIDALGO,0,0,3,3
10, INDE,1,0,3,4
10, LERDO,48,41,69,158
10, MAPIMI,0,49,39,88
10, MEZQUITAL,0,3,0,3
10, NAZAS,0,0,3,3
10, NOMBRE DE DIOS,87,18,2,107
10, OCAMPO,0,5,1,6
10, SANTA MARIA DEL OR,46,0,0,46
10, OTAES,0,0,0,0
10, PANUCO DE CORONADO,0,4,8,12
10, PENON BLANCO,0,2,1,3
10, POANAS,164,43,4,211
10, PUEBLO NUEVO,0,1,4,5
10, RODEO,0,0,10,10
10, SAN BERNARDO,0,0,0,0
10, SAN DIMAS,0,0,1,1
10, SAN JUAN DE GUADAL,0,0,0,0
10, SAN JUAN DEL RIO,0,3,0,3
10, SAN LUIS DEL CORDE,0,0,0,0
10, SAN PEDRO DEL GALL,0,0,0,0
10, SANTA CLARA,98,1,1,100
10, SANTIAGO PAPASQUIA,1372,4,28,1404
10, SUCHIL,0,1,0,1
10, TEPEHUANES,0,2,0,2
10, TLAHUALILO DE ZARA,0,0,33,33
10," NUEVO IDEAL, DGO",954,27,21,1002
10, VICENTE GUERRERO,246,0,24,270
11, ABASOLO,1111,1061,83,2255
11, ACAMBARO,231,94,15,340
11, ALLENDE,0,5,25,30
11, APASEO EL ALTO,181,437,3,621
11, APASEO EL GRANDE,0,4,0,4
11, CIUDAD MANUEL DOBL,57,326,5,388
11, CELAYA,532,65,613,1210
11, COMONFORT,0,6,0,6
11, CORTAZAR,183,426,30,639
11, CUERAMARO,93,9,4,106
11, DOLORES HIDALGO,347,19,41,407
11, DOCTOR MORA,0,1,3,4
11, GUANAJUATO,0,2,22,24
11, HUANIMARO,623,1,4,628
11, IRAPUATO,1323,503,1470,3296
11, JARAL DEL PROGRESO,183,0,6,189
11, JERECUARO,0,4,1,5
11, LEON,880,338,220,1438
11, MOROLEON,1229,0,2,1231
11, OCAMPO,0,51,0,51
11, PENJAMO,1205,103,485,1793
11, PUEBLO NUEVO,133,63,13,209
11, PURISIMA DEL RINCO,26,12,364,402
11, ROMITA,121,0,5,126
11, SAN DIEGO DE LA UN,227,0,0,227
11, SAN FRANCISCO DEL ,120,0,8,128
11, SAN JOSE ITURBIDE,380,60,10,450
11, SAN LUIS DE LA PAZ,693,1083,29,1805
11, SALAMANCA,643,63,125,831
11, SALVATIERRA,588,56,42,686
11, SAN FELIPE,1438,298,15,1751
11, SANTIAGO MARAVATIO,0,0,0,0
11, SILAO,382,0,62,444
11, SANTA CRUZ DE JUVE,108,0,2,110
11, TARANDACUAO,0,0,0,0
11, TARIMORO,58,21,2,81
11, TIERRABLANCA,100,0,0,100
11, URIANGATO,1016,0,1,1017
11, VALLE DE SANTIAGO,1348,555,151,2054
11, VILLAGRAN,0,10,7,17
11, XICHU,0,0,0,0
11, YURIRIA,482,0,72,554
12, ACAPULCO DE JUAREZ,322,30,15,367
12, AHUACUOTZINGO,57,0,0,57
12, ALCOZAUCA DE GUERR,133,0,0,133
12, APAXTLA,0,0,0,0
12, ARCELIA,54,14,0,68
12, ATLIXTAC,1,0,0,1
12, ATOYAC DE ALVAREZ,812,283,6,1101
12, AYUTLA DE LOS LIBR,0,102,1,103
12, AZOYU,706,0,0,706
12, BENITO JUAREZ,0,5,1,6
12, BUENAVISTA DE CUEL,0,0,1,1
12, CHILAPA DE ALVAREZ,4005,1166,1,5172
12, CHILPANCINGO DE LO,2355,967,10,3332
12, COAHUAYUTLA DE GUE,4,5,0,9
12, COCULA,0,3,0,3
12, COPALA,0,0,0,0
12, COPALILLO,48,1,0,49
12, COYUCA DE BENITEZ,951,4,2,957
12, COYUCA DE CATALAN,0,1,0,1
12, CUAJINICUILAPA,1281,129,0,1410
12, CUAUHTEPEC,0,0,0,0
12, CUTZAMALA DE PINZO,3063,0,0,3063
12, FLORENCIO VILLAREA,0,0,0,0
12, GENERAL HELIODORO ,0,44,0,44
12, HUAMUXTITLAN,0,19,0,19
12, HUITZUCO DE LOS FI,138,2,3,143
12, IGUALA DE LA INDEP,1195,89,12,1296
12, JOSE AZUETA,496,49,1,546
12, MALINALTEPEC,65,21,0,86
12, MARTIR DE CUILAPAN,0,4,0,4
12, METLATONOC,0,222,0,222
12, MOCHITLAN,401,0,0,401
12, OMETEPEC,261,15,0,276
12, PETATLAN,6,21,1,28
12, PILCAYA,2,5,0,7
12, PUNGARABATO,1145,30,11,1186
12, QUECHULTENANGO,1,20,0,21
12, SAN LUIS ACATLAN,1041,0,0,1041
12, SAN MARCOS,0,120,16,136
12, SAN MIGUEL TOTOLAP,0,2,0,2
12, TAXCO DE ALARCON,1973,234,2,2209
12, TECOANAPA,0,244,0,244
12, TECPAN DE GALEANA,751,52,2,805
12, TELOLOAPAN,4,1,3,8
12, TEPECOACUILCO DE T,490,27,0,517
12, TETIPAC,0,0,0,0
12, TIXTLA DE GUERRERO,0,81,1,82
12, TLACOACHISTLAHUACA,277,0,0,277
12, TLALCHAPA,12,3,0,15
12, TLAPA DE COMONFORT,3704,28,0,3732
12, TLAPEHUALA,24,0,1,25
12, LA UNION,0,4,0,4
12, XALPATLAHUAC,93,0,0,93
12, XOCHISTLAHUACA,44,85,0,129
12, ZUMPANGO DEL RIO,111,85,0,196
13, ACATLAN,2,1,0,3
13, ACAXOCHITLAN,43,13,0,56
13, ACTOPAN,84,12,7,103
13, AGUA BLANCA,454,15,0,469
13, AJACUBA,51,0,0,51
13, ALFAJAYUCAN,1,9,0,10
13, ALMOLOYA,7,16,0,23
13, APAN,4236,26,3,4265
13, EL ARENAL,57,2,0,59
13, ATITALAQUIA,0,8,0,8
13, ATLAPEXCO,0,0,0,0
13, CALNALI,0,0,0,0
13, CARDONAL,0,0,0,0
13, CHAPANTONGO,0,0,0,0
13, CHILCUAUTLA,0,0,0,0
13, CUAUTEPEC,1568,150,32,1750
13, EMILIANO ZAPATA,0,1,0,1
13, EPAZOYUCAN,25,27,2,54
13, FRANCISCO I MADERO,28,2,2,32
13, HUASCA DE OCAMPO,0,1,0,1
13, HUAUTLA,0,0,0,0
13, HUAZALINGO,0,0,0,0
13, HUEHUETLA,0,0,0,0
13, HUEJUTLA,53,602,1,656
13, HUICHAPAN,269,49,1,319
13, IXMIQUILPAN,188,102,11,301
13, JALTOCAN,0,0,0,0
13, LOLOTLA,0,0,0,0
13, METEPEC,29,0,61,90
13, METZQUITITLAN,62,2,0,64
13, METZTITLAN,155,0,0,155
13, MINERAL DE LA REFO,2312,229,5,2546
13, MINERAL DEL CHICO,2,3,0,5
13, MIXQUIAHUALA,312,46,1,359
13, MOLANGO,0,0,0,0
13, NOPALA DE VILLAGRA,0,2,6,8
13, OMITLAN DE JUAREZ,26,0,0,26
13, ORIZATLAN,0,0,0,0
13, PACHUCA,318,7,3,328
13, PROGRESO,162,5,4,171
13, SAN AGUSTIN TLAXIA,4031,46,0,4077
13, SAN BARTOLO TUTOTE,0,0,0,0
13, SAN SALVADOR,46,44,0,90
13, SANTIAGO DE ANAYA,31,2,0,33
13, SANTIAGO TULANTEPE,2,18,0,20
13, SINGUILUCAN,2,5,2,9
13, TASQUILLO,0,1,0,1
13, TECOZAUTLA,0,2,10,12
13, TEPEAPULCO,52,5,0,57
13, TEPEHUACAN DE GUER,0,0,0,0
13, TEPEJI DEL RIO (OC,0,0,0,0
13, TETEPANGO,49,0,0,49
13, VILLA DE TEZONTEPE,68,0,0,68
13, TEZONTEPEC DE ALDA,0,1,0,1
13, TIANGUISTENGO,0,0,0,0
13, TIZAYUCA,79,1757,20,1856
13, TLAHUELILPAN,0,0,3,3
13, TLANALAPA,0,0,0,0
13, TLANCHINOL,0,0,0,0
13, TLAXCOAPAN,169,0,18,187
13, TOLCAYUCA,751,0,70,821
13, TULA DE ALLENDE,3475,167,0,3642
13, TULANCINGO,1442,64,91,1597
13, XOCHIATIPAN,0,0,0,0
13, XOCHICOATLAN,0,0,0,0
13, YAHUALICA,0,0,0,0
13, ZACUALTIPAN,66,0,0,66
13, ZAPOTLAN DE JUAREZ,2293,91,37,2421
13, ZEMPOALA,2,98,3,103
13, ZIMAPAN,0,0,16,16
14, ACATIC,74,28,105,207
14, ACATLAN DE JUAREZ,733,3,21,757
14, AHUALULCO DE MERCA,2109,8,0,2117
14, AMACUECA,46,0,1,47
14, AMATITAN,82,16,1,99
14, AMECA,9140,1097,76,10313
14, ANTONIO ESCOBEDO,0,0,0,0
14, ARANDAS,98,9,76,183
14, EL ARENAL,390,34,9,433
14, ATEMAJAC DE BRIZUE,28,1,0,29
14, ATENGO,67,0,0,67
14, ATENGUILLO,52,0,0,52
14, ATOTONILCO EL ALTO,159,2,20,181
14, ATOYAC,8,0,1,9
14, AUTLAN DE NAVARRO,605,5,3,613
14, AYOTLAN (AYO EL CH,53,1,9,63
14, AYUTLA,0,0,1,1
14, LA BARCA,1363,195,22,1580
14, CABO CORRIENTES,48,0,0,48
14, CASIMIRO CASTILLO,1740,2,17,1759
14, CHAPALA,0,1,0,1
14, CHIQUILISTLAN,89,0,0,89
14, CIHUATLAN,0,0,0,0
14, CIUDAD GUZMAN,47,0,216,263
14, COCULA,164,0,32,196
14, COLOTLAN,0,0,10,10
14, CONCEPCION DE BUEN,0,0,0,0
14, CUAUTITLAN,30,7,0,37
14, CUAUTLA,0,0,0,0
14, CUQUIO,2749,76,32,2857
14, DEGOLLADO,0,1,0,1
14, EJUTLA,0,0,0,0
14, ENCARNACION DE DIA,414,15,41,470
14, ETZATLAN,496,0,79,575
14, EL GRULLO,799,1,2,802
14, GUACHINANGO,86,0,1,87
14, GUADALAJARA,20,70,1364,1454
14, HOSTOTIPAQUILLO,0,36,0,36
14, HUEJUCAR,1,0,0,1
14, HUEJUQUILLA EL ALT,0,0,0,0
14, LA HUERTA,400,337,2,739
14, IXTLAHUACAN DE LOS,245,12,38,295
14, IXTLAHUACAN DEL RI,709,170,14,893
14, JALOSTOTITLAN,528,165,9,702
14, JAMAY,27,28,26,81
14, JESUS MARIA,0,0,1,1
14, JILOTLAN DE LOS DO,155,0,0,155
14, JOCOTEPEC,32,6,0,38
14, JUANACATLAN,0,40,1,41
14, JUCHITLAN,125,0,0,125
14, LAGOS DE MORENO,279,167,15,461
14, EL LIMON,0,0,0,0
14, MAGDALENA,0,0,13,13
14, MANUEL M DIEGUEZ,15,0,0,15
14, MASCOTA,0,0,2,2
14, MAZAMITLA,2,0,4,6
14, MEZQUITIC,5,5,0,10
14, MEXTICACAN,0,1,0,1
14, MIXTLAN,136,0,0,136
14, OCOTLAN,377,58,63,498
14, OJUELOS DE JALISCO,197,0,0,197
14, PIHUAMO,80,4,0,84
14, PONCITLAN,413,99,65,577
14, PUERTO VALLARTA,0,18,59,77
14, VILLA PURIFICACION,51,26,1,78
14, QUITUPAN,9,4,2,15
14, SAN DIEGO DE ALEJA,0,0,0,0
14, SAN JUAN DE LOS LA,484,4,22,510
14, GOMEZ FARIAS,0,1,2,3
14, EL SALTO,0,0,2,2
14, SAN JULIAN,240,0,15,255
14, SAN MARCOS,0,0,3,3
14, SAN MARTIN HIDALGO,1547,17,0,1564
14, SAN MIGUEL EL ALTO,36,0,2,38
14, SAN SEBASTIAN DEL ,150,0,0,150
14, SAYULA,596,45,36,677
14, TALA,609,563,14,1186
14, TALPA DE ALLENDE,90,0,1,91
14, TAMAZULA DE GORDIA,2807,776,11,3594
14, TAPALPA,426,1,1,428
14, TECALITLAN,77,16,3,96
14, TECHALUTA DE MONTE,0,0,1,1
14, TECOLOTLAN,0,0,3,3
14, TENAMAXTLAN,211,2,4,217
14, TEOCALTICHE,364,3,17,384
14, TEOCUITATLAN DE CO,19,1,2,22
14, TEPATITLAN DE MORE,217,0,206,423
14, TEQUILA,0,0,1,1
14, TEUCHITLAN,2,1,0,3
14, TIZAPAN EL ALTO,0,0,0,0
14, TLAJOMULCO DE ZUNI,569,807,7,1383
14, TLAQUEPAQUE,5,1,8,14
14, TOLIMAN,145,0,0,145
14, TOMATLAN,335,25,3,363
14, TONALA,0,44,12,56
14, TONAYA,0,0,1,1
14, TOTOTLAN,928,83,89,1100
14, TUXCACUESCO,0,9,0,9
14, TUXPAN,413,75,0,488
14, UNION DE SAN ANTON,266,3,11,280
14, UNION DE TULA,34,0,0,34
14, VALLE DE GUADALUPE,1218,0,0,1218
14, VENUSTIANO CARRANZ,292,1,0,293
14, VILLA CORONA,54,0,0,54
14, VILLA HIDALGO,205,10,0,215
14, YAHUALICA DE GONZA,0,0,0,0
14, ZACOALCO DE TORRES,0,12,2,14
14, ZAPOPAN,53,9,427,489
14, ZAPOTILTIC,254,6,0,260
14, ZAPOTITLAN DE BADI,415,1,1,417
14, ZAPOTLAN DEL REY,120,89,13,222
14, ZAPOTLANEJO,221,204,21,446
15, ACAMBAY,0,0,1,1
15, ACOLMAN,0,2,0,2
15, ACULCO,0,5,0,5
15, AMANALCO,7,0,0,7
15, AMECAMECA,2,3,6,11
15, ATENCO,0,1,0,1
15, ATLACOMULCO,0,386,0,386
15, ATLAUTLA,7,1,0,8
15, AXAPUSCO,7,6,0,13
15, AYAPANGO,0,2,0,2
15, CALIMAYA,1,2,3,6
15, CAPULHUAC,0,0,15,15
15, CHALCO,0,2,0,2
15, CHAPA DE MOTA,0,0,1,1
15, CHIAUTLA,0,1,0,1
15, CHICONCUAC,0,0,0,0
15, COATEPEC HARINAS,0,0,0,0
15, CUAUTITLAN DE ROME,0,1,0,1
15, CUAUTITLAN IZCALLI,0,52,16,68
15, ECATEPEC DE MORELO,0,0,2,2
15, ECATZINGO,0,1,0,1
15, HUEHUETOCA,20,0,0,20
15, HUEYPOXTLA,0,2,0,2
15, IXTAPALUCA,18,8,9,35
15, IXTAPAN DE LA SAL,5,14,0,19
15, IXTLAHUACA,0,1,0,1
15, JALATLACO,0,2,0,2
15, JALTENCO,0,2,0,2
15, JILOTEPEC,0,1,0,1
15, JIQUIPILCO,11,1,2,14
15, JOCOTITLAN,270,2,0,272
15, JUCHITEPEC,0,8,3,11
15, LERMA,0,0,0,0
15, METEPEC,0,0,1,1
15, NAUCALPAN DE JUARE,0,23,32,55
15, NEZAHUALCOYOTL,0,0,22,22
15, NEXTLALPAN,0,1,0,1
15, NICOLAS ROMERO,9,3,2,14
15, OCOYOACAC,1,224778,118,224897
15, OTUMBA,0,3,1,4
15, OZUMBA,4,0,0,4
15, PAPALOTLA,0,1,0,1
15, LA PAZ,0,0,30,30
15, POLOTITLAN,0,0,0,0
15, SANTA MARIA RAYON,0,1,1,2
15, SAN FELIPE DEL PRO,21,0,0,21
15, SAN MARTIN DE LAS ,0,111,0,111
15, TECAMAC,0,1,0,1
15, TEJUPILCO,6243,2451,0,8694
15, TEMAMATLA,0,0,0,0
15, TEMASCALAPA,0,0,1,1
15, TEMASCALTEPEC,0,0,0,0
15, TEMOAYA,40,0,2,42
15, TENANCINGO,0,1519,4,1523
15, TENANGO DEL AIRE,0,1,0,1
15, TENANGO DEL VALLE,0,0,0,0
15, TEOLOYUCAN,0,1,0,1
15, TEOTIHUACAN,10,0,0,10
15, TEPETLAOXTOC,0,2,0,2
15, TEPETLIXPA,0,1,0,1
15, TEPOTZOTLAN,0,2,1,3
15, TEQUIXQUIAC,0,0,2,2
15, TEXCALTITLAN,0,0,0,0
15, TEXCOCO,3176,9,13,3198
15, SANTIAGO TIANGUIST,0,0,14,14
15, TLALMANALCO,0,0,1,1
15, TLANEPANTLA DE BAZ,0,0,6,6
15, TOLUCA,6,2836,312,3154
15, TONATICO,0,4,1,5
15, TULTITLAN,0,0,37,37
15, VALLE DE BRAVO,0,0,0,0
15, VILLA DE ALLENDE,0,0,0,0
15, VILLA GUERRERO,0,0,1,1
15, XONACATLAN,0,771,1,772
15, ZACUALPAN,0,0,0,0
15, ZINACANTEPEC,0,0,17,17
15, ZUMPAHUACAN,0,0,2,2
15, ZUMPANGO,0,1,2,3
15, VALLE DE CHALCO SO,0,1,0,1
15, SAN JOSE DEL RINCO,3,1,3,7
16, ACUITZIO,0,3,1,4
16, AGUILILLA,226,1,1,228
16, ALVARO OBREGON,10,15,0,25
16, ANGAMACUTIRO,0,34,0,34
16, ANGANGUEO,0,1,2,3
16, APATZINGAN,779,7,4,790
16, APORO,0,0,0,0
16, ARIO,410,7,4,421
16, ARTEAGA,0,0,0,0
16, BRISENAS DE MATAMO,0,4,21,25
16, BUENAVISTA,720,21,3,744
16, CARACUARO,0,0,0,0
16, CHARAPAN,64,0,0,64
16, CHARO,0,0,0,0
16, CHAVINDA,0,1,0,1
16, CHERAN,0,3,0,3
16, CHILCHOTA,0,6,0,6
16, CHINICUILA,0,0,0,0
16, CHURINTZIO,0,0,0,0
16, CHURUMUCO,4,7,0,11
16, COAHUAYANA,0,0,0,0
16, CONTEPEC,251,0,0,251
16, COPANDARO DE GALEA,114,0,0,114
16, COTIJA,0,0,0,0
16, CUITZEO,525,0,0,525
16, ECUANDUREO,0,10,10,20
16, EPITACIO HUERTA,0,13,0,13
16, GABRIEL ZAMORA,16,5,0,21
16, HIDALGO,438,173,2,613
16, LA HUACANA,94,4,0,98
16, HUETAMO,0,0,0,0
16, HUIRAMBA,0,2,0,2
16, INDAPARAPEO,0,0,1,1
16, IRIMBO,0,0,0,0
16, IXTLAN,76,11,0,87
16, JACONA,189,156,137,482
16, JIMENEZ,0,0,52,52
16, JIQUILPAN,182,19,0,201
16, JOSE SIXTO VERDUZC,925,36,33,994
16, JUNGAPEO,13,0,0,13
16, JUAREZ,197,2,0,199
16, LAGUNILLAS,1026,0,0,1026
16, MADERO,0,0,0,0
16, MARAVATIO,268,0,4,272
16, LAZARO CARDENAS,21,8,1,30
16, MORELIA,1055,1079,284,2418
16, NAHUATZEN,330,7,0,337
16, NOCUPETARO,0,0,0,0
16, NUEVO PARANGARICUT,35,28,0,63
16, NUEVO URECHO,3,1,0,4
16, NUMARAN,423,26,6,455
16, OCAMPO,0,0,0,0
16, PAJACUARAN,7,13,2,22
16, PANINDICUARO,0,0,1,1
16, PARACHO,298,0,0,298
16, PARACUARO,15,3,0,18
16, PATZCUARO,639,11,2,652
16, PENJAMILLO,0,4,0,4
16, PERIBAN,0,4,19,23
16, LA PIEDAD,486,122,72,680
16, PUREPERO,68,0,0,68
16, PURUANDIRO,1777,92,106,1975
16, QUERENDARO,420,95,1,516
16, QUIROGA,706,0,1,707
16, REGULES,81,21,0,102
16, LOS REYES,173,34,23,230
16, SAHUAYO,345,0,24,369
16, SAN LUCAS,0,0,0,0
16, SANTA ANA MAYA,34,0,7,41
16, SALVADOR ESCALANTE,3,3,0,6
16, SENGUIO,0,0,0,0
16, SUSUPUATO,0,0,0,0
16, TACAMBARO,996,4766,10,5772
16, TANCITARO,411,57,39,507
16, TANGAMANDAPIO,43,0,0,43
16, TANGANCICUARO,0,11,4,15
16, TANHUATO,257,14,16,287
16, TARETAN,1,4,0,5
16, TARIMBARO,0,0,0,0
16, TEPALCATEPEC,594,2,2,598
16, TINGAMBATO,657,48,0,705
16, TINGUINDIN,137,19,0,156
16, TIQUICHEO,0,0,0,0
16, TLALPUJAHUA,0,9,0,9
16, TUMBISCATIO DE RUI,531,1,0,532
16, TURICATO,0,0,0,0
16, TUXPAN,230,0,0,230
16, TUZANTLA,328,0,0,328
16, TZITZIO,0,0,0,0
16, URUAPAN,1574,1273,265,3112
16, VENUSTIANO CARRANZ,114,41,4,159
16, VILLAMAR,37,0,13,50
16, VISTAHERMOSA,130,43,11,184
16, YURECUARO,61,244,9,314
16, ZACAPU,78,18,0,96
16, ZAMORA,1280,13677,1158,16115
16, MUGICA,78,3,4,85
16, ZINAPARO,50,0,0,50
16, ZINAPECUARO,662,6,32,700
16, ZITACUARO,817,84,1,902
17, AMACUZAC,0,333,4,337
17, ATLATLAHUACAN,0,12,0,12
17, AXOCHIAPAN,0,0,0,0
17, AYALA,2486,8355,0,10841
17, COATLAN DEL RIO,449,1302,0,1751
17, CUAUTLA,2497,543,14,3054
17, CUERNAVACA,0,276,15,291
17, EMILIANO ZAPATA,1953,1,2,1956
17, HUITZILAC,524,0,0,524
17, JANTETELCO,550,0,0,550
17, JIUTEPEC,0,0,5,5
17, JOJUTLA,1419,276,5,1700
17, JONACATEPEC,818,530,0,1348
17, MAZATEPEC,232,453,20,705
17, MIACATLAN,1834,5,4,1843
17, OCUITUCO,462,706,0,1168
17, PUENTE DE IXTLA,2492,601,8,3101
17, TEMIXCO,22,45,0,67
17," TEMOAC, MOR.",8,0,0,8
17, TEPALCINGO,0,0,0,0
17, TEPOZTLAN,55,365,0,420
17, TETECALA,2924,1,0,2925
17, TETELA DEL VOLCAN,1,0,0,1
17, TLALNEPANTLA,17,13,0,30
17, TLALTIZAPAN,1096,150,15,1261
17, TLAQUILTENANGO,382,142,0,524
17, TLAYACAPAN,411,1022,0,1433
17, TOTOLAPAN,0,2,0,2
17, YAUTEPEC,773,455,4,1232
17, YECAPIXTLA,0,7,0,7
17, ZACATEPEC,4269,320,27,4616
17, ZACUALPAN,0,336,0,336
18, ACAPONETA,1576,0,127,1703
18, AHUACATLAN,1253,1,23,1277
18, AMATLAN DE CANAS,2782,267,53,3102
18, COMPOSTELA,2952,464,7,3423
18, IXTLAN,247,6,17,270
18, JALA,841,0,0,841
18, XALISCO,1679,31,0,1710
18, NAYAR,174,0,0,174
18, ROSAMORADA,600,43,1,644
18, RUIZ,1162,20,0,1182
18, SAN BLAS,2093,0,7,2100
18, SAN PEDRO LAGUNILL,0,0,0,0
18, SANTA MARIA DEL OR,5034,3,0,5037
18, SANTIAGO IXCUINTLA,4754,88,258,5100
18, TECUALA,3941,4,17,3962
18, TEPIC,5217,153,101,5471
18, TUXPAN,1573,1,2,1576
18, LA YESCA,0,0,1,1
19, AGUALEGUAS,0,0,0,0
19, ALLENDE,0,0,33,33
19, ANAHUAC,0,0,0,0
19, ARAMBERRI,2,0,3,5
19, CADEREYTA JIMENEZ,42,5,95,142
19, CHINA,0,0,10,10
19, CIENEGA DE FLORES,0,0,5,5
19, DOCTOR ARROYO,512,4,0,516
19, DOCTOR COSS,0,0,0,0
19, DOCTOR GONZALEZ,0,0,12,12
19, GARZA GARCIA,0,0,6,6
19, GENERAL BRAVO,0,1,4,5
19, GENERAL ESCOBEDO,0,0,0,0
19, GENERAL TERAN,42,33,73,148
19, GENERAL TREVINO,0,0,2,2
19, GENERAL ZUAZUA,0,0,13,13
19, GUADALUPE,0,5,84,89
19, HIDALGO,0,0,0,0
19, LAMPAZOS DE NARANJ,0,0,4,4
19, LINARES,0,0,27,27
19, MARIN,0,0,21,21
19, MIER Y NORIEGA,0,1,0,1
19, MINA,0,0,24,24
19, MONTEMORELOS,0,0,88,88
19, MONTERREY,0,0,66,66
19, PARAS,0,0,0,0
19, PESQUERIA,0,0,7,7
19, LOS RAMONES,0,5,6,11
19, RAYONES,0,0,0,0
19, SABINAS HIDALGO,0,0,24,24
19, GUERRERO,0,0,3,3
19, SALINAS VICTORIA,0,0,13,13
19, SAN NICOLAS DE LOS,0,0,68,68
19, SANTIAGO,0,0,2,2
19, VALLECILLO,0,0,0,0
20, ACATLAN DE PEREZ F,2422,579,56,3057
20, ASUNCION CACALOTEP,0,0,0,0
20, ASUNCION IXTALTEPE,59,0,0,59
20, ASUNCION NOCHIXTLA,0,197,0,197
20, AYOTZINTEPEC,0,0,0,0
20, EL BARRIO,0,98,0,98
20, CANDELARIA LOXICHA,28,0,0,28
20, CHAHUITES,181,101,7,289
20, CHALCATONGO DE HID,0,0,0,0
20, LA CIENEGA,0,0,0,0
20, CIUDAD IXTEPEC,69,0,0,69
20, CONCEPCION BUENAVI,0,0,0,0
20, EJUTLA DE CRESPO,33,61,0,94
20, EL ESPINAL,0,1,0,1
20, ESPIRITU SANTO TAM,0,0,0,0
20, GUEVEA DE HUMBOLDT,0,0,0,0
20, HIDALGO YALALAG,28,0,8,36
20, HUAJUAPAN DE LEON,306,200,1,507
20, HUATLA DE JIMENEZ,0,9,0,9
20, IXTLAN DE JUAREZ,83,13,0,96
20, JUCHITAN DE ZARAGO,384,991,1,1376
20, LOMA BONITA,5451,148,1,5600
20, MAGDALENA APASCO,54,8,0,62
20, MAGDALENA JALTEPEC,0,0,0,0
20, MAGDALENA MIXTEPEC,0,0,0,0
20, MAGDALENA TEQUISIS,0,0,0,0
20, MARTIRES DE TACUBA,0,1,0,1
20, MATIAS ROMERO,520,495,0,1015
20, MAZATLAN DE FLORES,0,0,2,2
20, MIAHUATLAN DE PORF,64,39,0,103
20, NAZARENO ETLA,47,7,0,54
20, NILTEPEC,60,8,0,68
20, OAXACA DE JUAREZ,5137,286,13,5436
20, OCOTLAN DE MORELOS,471,417,0,888
20, LA PE,83,0,0,83
20, PINOTEPA DE DON LU,0,0,0,0
20, PLUMA HIDALGO,0,0,0,0
20, PUTLA DE GUERRERO,0,63,1,64
20, REFORMA DE PINEDA,0,4,0,4
20, SALINA CRUZ,41,101,0,142
20, SAN AGUSTIN ATENAN,0,0,0,0
20, SAN AGUSTIN ETLA,130,0,0,130
20, SAN AGUSTIN LOXICH,71,8,0,79
20, SAN ANDRES HUAXPAL,11,2,0,13
20, SAN ANDRES SINAXTL,0,32,0,32
20, SAN ANDRES TEOTILA,0,0,0,0
20, SAN ANDRES ZAUTLA,0,34,0,34
20, SAN ANTONINO CASTI,16,0,0,16
20, SAN BALTAZAR LOXIC,0,0,0,0
20, SAN BERNARDO MIXTE,0,0,0,0
20, SAN BLAS ATEMPA,118,132,0,250
20, SAN CRISTOBAL AMAT,0,0,0,0
20, SAN DIONISIO DEL M,0,0,0,0
20, SAN DIONISIO OCOTE,0,0,0,0
20, SAN FELIPE JALAPA ,0,0,1,1
20, SAN FELIPE TEJALAP,0,0,0,0
20, SAN FRANCISCO DEL ,16,0,0,16
20, SAN FRANCISCO IXHU,0,1,0,1
20, SAN FRANCISCO LACH,16,15,0,31
20, SAN FRANCISCO TELI,115,50,0,165
20, SAN GABRIEL MIXTEP,147,47,1,195
20, SAN JOSE CHILTEPEC,0,5,0,5
20, SAN JUAN BAUTISTA ,0,0,6,6
20, SAN JUAN BAUTISTA ,5,0,0,5
20, SAN JUAN BAUTISTA ,1,1,0,2
20, SAN JUAN BAUTISTA ,0,0,0,0
20, SAN JUAN BAUTISTA ,4445,1033,79,5557
20, VALLE NACIONAL,0,0,0,0
20, SAN JUAN CACAHUATE,30,14,0,44
20, SAN JUAN CHILATECA,0,0,0,0
20, SAN JUAN COATZOSPA,0,0,0,0
20, SAN JUAN COTZOCON,1,4,13,18
20, SAN JUAN DEL ESTAD,0,20,0,20
20, SAN JUAN GUICHICOV,66,0,0,66
20, SAN JUAN JUQUILA M,0,0,0,0
20, SAN JUAN LALANA,0,0,0,0
20, SAN JUAN MAZATLAN,1,0,0,1
20, SAN JUAN SAYULTEPE,0,2,0,2
20, SAN JUAN TAMAZOLA,0,0,0,0
20, SAN JUAN TEPOSCOLU,0,0,0,0
20, SAN LORENZO,0,0,0,0
20, SAN LORENZO CACAOT,91,59,0,150
20, SAN LUCAS CAMOTLAN,0,0,0,0
20, SAN LUCAS OJITLAN,0,0,0,0
20, SAN LUCAS ZOQUIAPA,16,0,0,16
20, SAN MATEO DEL MAR,0,0,0,0
20, SAN MATEO RIO HOND,0,1,0,1
20, SAN MIGUEL AMATLAN,146,0,0,146
20, SAN MIGUEL CHIMALA,0,0,0,0
20, SAN MIGUEL DEL PUE,70,0,0,70
20, SAN MIGUEL EL GRAN,217,153,0,370
20, SAN MIGUEL MIXTEPE,0,0,0,0
20, SAN MIGUEL QUETZAL,0,0,0,0
20, SAN MIGUEL SOLA DE,68,31,0,99
20, SAN MIGUEL SOYALTE,0,2,0,2
20, SAN MIGUEL SUCHIXT,47,0,0,47
20, SAN PABLO COATLAN,0,0,0,0
20, SAN PABLO ETLA,158,80,4,242
20, SAN PABLO HUITZO,30,24,0,54
20, SAN PABLO HUIXTEPE,1396,89,0,1485
20, SAN PABLO VILLA DE,166,80,0,246
20, SAN PEDRO AMUZGOS,0,0,0,0
20, SAN PEDRO APOSTOL,78,29,0,107
20, SAN PEDRO ATOYAC,0,0,0,0
20, SAN PEDRO COMITANC,0,0,0,0
20, SAN PEDRO EL ALTO,0,0,0,0
20, SAN PEDRO HUAMELUL,0,0,0,0
20, SAN PEDRO IXTLAHUA,0,0,0,0
20, SAN PEDRO MIXTEPEC,771,515,4,1290
20, SAN PEDRO POCHUTLA,105,320,4,429
20, SAN PEDRO QUIATONI,0,0,0,0
20, SAN PEDRO TAPANATE,23,210,5,238
20, SAN PEDRO TEUTILA,0,0,0,0
20, SAN PEDRO TOTOLAPA,45,14,0,59
20, SAN PEDRO TUTUTEPE,142,67,2,211
20, SAN PEDRO Y SAN PA,0,0,3,3
20, SAN PEDRO Y SAN PA,0,1,0,1
20, SAN SEBASTIAN TUTL,81,0,0,81
20, SANTA ANA TAVELA,0,0,0,0
20, SANTA CATARINA JUQ,337,288,3,628
20, SANTA CATARINA LOX,0,0,0,0
20, SANTA CATARINA MEC,0,1,0,1
20, SANTA CRUZ AMILPAS,65,0,0,65
20, SANTA CRUZ ITUNDUJ,0,20,0,20
20, SANTA CRUZ MIXTEPE,0,0,0,0
20, SANTA CRUZ TACACHE,0,0,0,0
20, SANTA CRUZ XOXOCOT,188,8,0,196
20, SANTA LUCIA DEL CA,1,1,0,2
20, SANTA MARIA ALOTEP,14,0,0,14
20, SANTA MARIA ASUNCI,213,2173,0,2386
20, SANTA MARIA AYOQUE,896,0,0,896
20, SANTA MARIA AZOMPA,113,0,1,114
20, SANTA MARIA CHILCH,0,0,0,0
20, SANTA MARIA CHIMAL,0,0,0,0
20, SANTA MARIA COLOTE,1286,6,0,1292
20, SANTA MARIA CORTIJ,0,0,0,0
20, SANTA MARIA COYOTE,155,0,0,155
20, SANTA MARIA DEL TU,0,0,0,0
20, SANTA MARIA GUIENA,679,0,0,679
20, SANTA MARIA HUATUL,86,151,0,237
20, SANTA MARIA HUAZOL,2,3,1,6
20, SANTA MARIA IPALAP,0,0,0,0
20, SANTA MARIA JACATE,0,0,0,0
20, SANTA MARIA JALAPA,0,0,0,0
20, SANTA MARIA MIXTEQ,0,45,0,45
20, SANTA MARIA OZOLOT,0,0,0,0
20, SANTA MARIA PETAPA,157,0,0,157
20, SANTA MARIA SOLA,0,0,0,0
20, SANTA MARIA TONAME,1181,8,4,1193
20, SANTA MARIA TOTOLA,900,0,0,900
20, SANTA MARIA YUCUHI,0,0,0,0
20, SANTA MARIA ZACATE,0,94,0,94
20, SANTA MARIA ZOQUIT,0,0,0,0
20, SANTIAGO ASTATA,0,0,0,0
20, SANTIAGO CHAZUMBA,0,0,0,0
20, SANTIAGO CHOAPAN,0,0,0,0
20, SANTIAGO COMALTEPE,0,0,0,0
20, SANTIAGO JAMILTEPE,77,3,2,82
20, SANTIAGO JOCOTEPEC,0,0,0,0
20, SANTIAGO JUXTLAHUA,0,306,0,306
20, SANTIAGO LACHIGUIR,0,0,0,0
20, SANTIAGO LLANO GRA,1,4,3,8
20, SANTIAGO MATATLAN,0,0,0,0
20, SANTIAGO MILTEPEC,0,0,0,0
20, SANTIAGO PINOTEPA ,749,26,0,775
20, SANTIAGO SUCHILQUI,76,186,9,271
20, SANTIAGO TAMAZOLA,0,0,0,0
20, TEOTONGO,0,0,0,0
20, SANTIAGO TEXTITLAN,0,1,0,1
20, SANTIAGO TILLO,0,0,0,0
20, SANTIAGO YAVEO,0,0,0,0
20, SANTIAGO YOSONDUA,96,71,0,167
20, SANTIAGO ZACATEPEC,0,0,0,0
20, NUEVO ZOQUIAPAN,4,0,0,4
20, SANTO DOMINGO,68,6,0,74
20, SANTO DOMINGO ARME,0,0,0,0
20, SANTO DOMINGO DE M,0,0,0,0
20, SANTO DOMINGO PETA,0,0,0,0
20, SANTO DOMINGO TEHU,424,1395,0,1819
20, SANTO DOMINGO TEPU,0,0,0,0
20, SANTO DOMINGO TONA,0,0,0,0
20, SANTO DOMINGO ZANA,0,2,4,6
20, SANTO TOMAS MAZALT,9,19,0,28
20, SANTO TOMAS TAMAZU,0,5,0,5
20, SANTOS REYES NOPAL,1140,0,0,1140
20, SILACAYOAPAN,0,130,0,130
20, SOLEDAD ETLA,21,0,0,21
20, TAMAZULAPAN DEL PR,200,163,0,363
20, TATALTEPEC DE VALD,0,0,0,0
20, TEZOATLAN DE SEGUR,63,38,0,101
20, TLACOLULA DE MATAM,77,63,0,140
20, TLALIXTAC DE CABRE,177,0,0,177
20, UNION HIDALGO,275,130,0,405
20, YAXE,0,0,0,0
20, ZAACHILA,122,195,4,321
20, ZIMATLAN DE ALVARE,4712,0,0,4712
21, ACAJETE,62,2,0,64
21, ACATENO,6,0,3,9
21, ACATLAN,0,0,0,0
21, ACATZINGO,8,141,70,219
21, ACTEOPAN,84,0,0,84
21, AHUATLAN,0,0,0,0
21, AHUEHUETITLA,0,0,0,0
21, AJALPAN,279,80,8,367
21, ALBINO ZERTUCHE,0,0,0,0
21, ALJOJUCA,25,1,0,26
21, ALTEPEXI,86,296,1,383
21, AMOZOC,57,8,7,72
21, AQUIXTLA,19,20,1,40
21, ATEMPAN,6,0,0,6
21, ATEXCAL,0,0,0,0
21, ATLIXCO,22,23,0,45
21, ATOYATEMPAN,3,2,0,5
21, ATZITZINTLA,0,0,0,0
21, ATZITZIHUACAN,0,0,0,0
21, AXUTLA,0,0,0,0
21, AYOTOXCO DE GUERRE,0,0,1,1
21, CALPAN,0,16,0,16
21, CHALCHICOMULA DE S,0,2,5,7
21, CHIAUTLA,11,11,0,22
21, CHIAUTZINGO,32,183,3,218
21, CHICHIQUILA,0,4,0,4
21, CHIETLA,1959,255,39,2253
21, CHIGNAHUAPAN,311,571,23,905
21, CHIGNAUTLA,32,12,0,44
21, CHILA DE LA SAL,2,0,0,2
21, CHILA HONEY,0,0,0,0
21, CHILCHOTLA,0,0,0,0
21, COATZINGO,0,0,0,0
21, COHUECAN,0,0,0,0
21, COXCATLAN,84,288,0,372
21, COYOTEPEC,0,0,0,0
21, CUAUTINCHAN,0,2,4,6
21, CUAYUCA,0,0,2,2
21, CUETZALAN DEL PROG,844,0,0,844
21, CUAPIAXTLA DE MADE,15,0,0,15
21, CUYOACO,110,19,4,133
21, EPATLAN,0,0,0,0
21, ESPERANZA,0,0,0,0
21, GENERAL FELIPE ANG,0,2,0,2
21, GUADALUPE VICTORIA,97,44,3,144
21, HUAQUECHULA,0,40,0,40
21, HUATLATLAUCA,0,0,0,0
21, HUAUCHINANGO,215,51,2,268
21, HUEHUETLAN EL CHIC,176,153,0,329
21, HUEJOTZINGO,13,15,9,37
21, HUEYTAMALCO,310,64,0,374
21, HUITZILAN DE SERDA,1388,0,1,1389
21, HUITZILTEPEC,245,139,2,386
21, IXCAMILPA DE GUERR,3,0,0,3
21, IXCAQUIXTLA,0,0,0,0
21, IXTACAMAXTITLAN,10,0,0,10
21, IXTEPEC,0,0,0,0
21, IZUCAR DE MATAMORO,557,98,0,655
21, JALPAN,1,2,0,3
21, JOLALPAN,0,0,0,0
21, JOPALA,5,0,0,5
21, JUAN C BONILLA,0,3,0,3
21, JUAN GALINDO,16,0,0,16
21, JUAN N MENDEZ,0,0,0,0
21, LAFRAGUA,0,0,0,0
21, LIBRES,111,22,12,145
21, MAZAPILTEPEC DE JU,460,0,0,460
21, MOLCAXAC,0,0,0,0
21, MORELOS CANADA,0,0,0,0
21, NEALTICAN,0,0,0,0
21, NICOLAS BRAVO,0,0,0,0
21, NOPALUCAN,58,0,0,58
21, OCOTEPEC,10,7,0,17
21, OCOYUCAN,0,1,0,1
21, OLINTLA,11,7,0,18
21, ORIENTAL,58,12,0,70
21, PALMAR DE BRAVO,0,1,0,1
21, PANTEPEC,101,0,0,101
21, PETLALCINGO,0,0,0,0
21, PUEBLA,1431,2,76,1509
21, QUECHOLAC,0,1,0,1
21, RAFAEL LARA GRAJAL,20,0,1,21
21, LOS REYES DE JUARE,0,0,0,0
21, SAN ANDRES CHOLULA,226,8,0,234
21, SAN FELIPE TEOTLAL,7,0,0,7
21, SAN GABRIEL CHILAC,128,0,0,128
21, SAN GREGORIO ATZOM,0,0,1,1
21, SAN JERONIMO TECUA,0,0,1,1
21, SAN JERONIMO XAYAC,1476,0,0,1476
21, SAN JOSE CHIAPA,1,0,2,3
21, SAN JOSE MIAHUATLA,0,338,0,338
21, SAN JUAN ATENCO,2,0,0,2
21, SAN MARTIN TEXMELU,0,4,2,6
21, SAN MATIAS TLALANC,0,9,0,9
21, SAN MIGUEL XOXTLA,20,19,0,39
21, SAN NICOLAS DE BUE,3,10,0,13
21, SAN NICOLAS DE LOS,0,0,0,0
21, SAN PEDRO CHOLULA,5,0,0,5
21, SAN PEDRO YELOIXTL,0,4,0,4
21, SAN SALVADOR EL SE,3,15,130,148
21, SAN SALVADOR EL VE,7,22,0,29
21, SAN SALVADOR HUIXC,0,0,2,2
21, SANTA INES AHUATEM,1,2,0,3
21, SANTA ISABEL CHOLU,2,0,0,2
21, SANTIAGO MIAHUATLA,61,156,0,217
21, SANTO DOMINGO HUEH,0,0,0,0
21, SANTO TOMAS HUEYOT,0,0,0,0
21, SOLTEPEC,104,12,1,117
21, TECALI DE HERRERA,145,136,0,281
21, TECAMACHALCO,123,81,17,221
21, TECOMATLAN,0,9,0,9
21, TEHUACAN,67,2,8,77
21, TEHUITZINGO,0,6,0,6
21, TENAMPULCO,0,0,0,0
21, TEOTLALCO,0,1,0,1
21, TEPANCO DE LOPEZ,175,230,177,582
21, TEPATLAXCO DE HIDA,0,73,0,73
21, TEPEACA,192,3052,1,3245
21, TEPEOJUMA,0,2,0,2
21, TEPEXCO,56,0,0,56
21, TEPEXI DE RODRIGUE,39,0,4,43
21, TEPEYAHUALCO,160,47,16,223
21, TEPEYAHUALCO CUAUH,0,0,0,0
21, TETELA DE OCAMPO,8,7,14,29
21, TETELES DE AVILA C,0,0,1,1
21, TEZIUTLAN,277,10,0,287
21, TIANGUISMANALCO,0,0,0,0
21, TILAPA,0,0,3,3
21, TLACHICHUCA,87,13,2,102
21, TLACOTEPEC DE BENI,0,121,0,121
21, TLACUILOTEPEC,0,3,0,3
21, TLAHUAPAN,120,69,1,190
21, TLANEPANTLA,0,0,0,0
21, TLAOLA,0,0,0,0
21, TLAPANALA,0,8,0,8
21, TLATLAUQUITEPEC,86,20,1,107
21, TLAXCO,0,4,0,4
21, TOCHIMILCO,0,1,0,1
21, TOCHTEPEC,6,0,0,6
21, TULCINGO,2,0,0,2
21, VENUSTIANO CARRANZ,0,18,0,18
21, VICENTE GUERRERO,0,0,0,0
21, XICOTEPEC,270,231,7,508
21, XICOTLAN,0,0,0,0
21, XIUTETELCO,0,0,0,0
21, XOCHILTEPEC,0,0,0,0
21, XOCHITLAN TODOS SA,121,0,0,121
21, YAHUALTEPEC,0,10,1,11
21, ZACAPALA,0,0,0,0
21, ZACAPOAXTLA,38,1,0,39
21, ZACATLAN,429,62,1,492
21, ZAPOTITLAN,0,0,0,0
21, ZARAGOZA,10,2,0,12
21, ZAUTLA,28,9,0,37
21, ZIHUATEUTLA,141,0,26,167
21, ZINACANTEPEC,294,37,2,333
21, ZONGOZOTLA,0,6,0,6
22, AMEALCO,25,9,15,49
22, PINAL DE AMOLES,4,1,1,6
22, ARROYO SECO,76,27,41,144
22, CADEREYTA DE MONTE,21,23,13,57
22, COLON,27,8,157,192
22, CORREGIDORA,550,408,110,1068
22, EZEQUIEL MONTES,62,3,212,277
22, HUIMILPAN,533,2,66,601
22, JALPAN DE SERRA,360,121,24,505
22, LANDA DE MATAMOROS,15,0,3,18
22, EL MARQUES,1001,887,159,2047
22, PEDRO ESCOBEDO,1153,12,24,1189
22, PENAMILLER,6,4,8,18
22, QUERETARO,1041,408,2525,3974
22, SAN JOAQUIN,4,3,14,21
22, SAN JUAN DEL RIO,1086,6,33,1125
22, TEQUISQUIAPAN,215,6,11,232
22, TOLIMAN,14,2,11,27
23, BENITO JUAREZ,0,0,44,44
23, JOSE MARIA MORELOS,0,255,0,255
23, COZUMEL,0,0,0,0
23, FELIPE CARRILLO PU,145,474,0,619
23, ISLA MUJERES,0,9,0,9
23, LAZARO CARDENAS,458,64,3,525
23, OTHON P BLANCO,24269,9111,957,34337
23, SOLIDARIDAD,0,286,24,310
24, AHUALULCO,0,0,0,0
24, ALAQUINES,0,3,0,3
24, AQUISMON,1,0,5,6
24, ARMADILLO DE LOS I,0,0,0,0
24, CARDENAS,0,0,0,0
24, CATORCE,0,0,0,0
24, CIUDAD FERNANDEZ,19,1,0,20
24, CEDRAL,0,0,0,0
24, CERRITOS,0,0,0,0
24, CHARCAS,0,0,0,0
24, CIUDAD VALLES,1910,405,69,2384
24, CIUDAD DEL MAIZ,10711,840,63,11614
24, EBANO,397,312,7,716
24, CIUDAD SANTOS,0,0,1,1
24, GUADALCAZAR,454,1,0,455
24," VILLA DE ARISTA, S",0,0,0,0
24, VILLA DE GUADALUPE,16,7,3,26
24, HUEHUETAN,0,0,0,0
24, LAGUNILLAS,0,0,0,0
24, MATEHUALA,133,3,1,137
24, MEXQUITIC,35,0,0,35
24, MOCTEZUMA,0,5,0,5
24, VILLA DE LA PAZ,0,0,0,0
24, SAN CIRO ACOSTA,0,0,0,0
24, VILLA DE RAMOS,171,3,13,187
24, RAYON,0,0,0,0
24, RIOVERDE,1470,16,18,1504
24, SAN NICOLAS TOLENT,0,0,0,0
24, SALINAS,0,0,0,0
24, SAN LUIS POTOSI,1899,1203,109,3211
24, SANTA CATARINA,0,0,0,0
24, SANTO DOMINGO,0,0,0,0
24, SOLEDAD DIEZ GUTIE,19,12,0,31
24, TAMASOPO,1669,53,10,1732
24, TAMAZUNCHALE,0,0,1,1
24, TAMPACAN,0,0,1,1
24, TAMPAMOLON,0,0,0,0
24, TAMUIN,0,13,139,152
24, SAN VICENTE TANCUY,0,0,5,5
24, TANLAJAS,1,0,1,2
24, TANQUIAN DE ESCOBE,11,54,7,72
24, TIERRANUEVA,1,0,0,1
24, VENADO,0,1,1,2
24, VENEGAS,0,0,0,0
24, VILLA DE ARRIAGA,115,1,4,120
24, VILLA HIDALGO,10,0,1,11
24, VILLA DE ARISTA,0,0,0,0
24, VILLA DE REYES,14,0,8,22
24, VILLA JUAREZ,0,0,0,0
24, VILLA DE ZARAGOZA,0,3,0,3
25, AHOME,12327,2195,1839,16361
25, ANGOSTURA,624,102,53,779
25, BADIRAGUATO,0,0,1,1
25, CHOIX,0,0,0,0
25, COSALA,0,0,1,1
25, CULIACAN,9045,7673,1991,18709
25, EL FUERTE,396,121,94,611
25, ELOTA,214,106,129,449
25, ESCUINAPA,62,0,6,68
25, GUASAVE,2408,2053,840,5301
25, MAZATLAN,1371,582,741,2694
25, MOCORITO,40,0,0,40
25, NAVOLATO,1109,499,1329,2937
25, ROSARIO,314,2,5,321
25, SALVADOR ALVARADO,292,212,389,893
25, SAN IGNACIO,0,0,3,3
25, SINALOA,309,57,54,420
26, ACONCHI,52,14,9,75
26, AGUA PRIETA,1,3,8,12
26, ALAMOS,135,23,4,162
26, ALTAR,0,1,0,1
26, ARIVECHI,6,5,0,11
26, ARIZPE,21,12,1,34
26, ATIL,0,9,2,11
26, BACADEHUACHI,56,7,2,65
26, BACANORA,10,18,0,28
26, BACERAC,0,1,0,1
26, BACUM,2,12,44,58
26, BANAMICHI,61,5,4,70
26, BAVIACORA,12,15,1,28
26, BAVISPE,8,7,0,15
26, BENITO JUAREZ,0,1,0,1
26, BENJAMIN HILL,0,2,0,2
26, CABORCA,227,1140,138,1505
26, CAJEME,1203,773,2176,4152
26, CANANEA,0,0,1,1
26, CARBO,22,7,2,31
26, LA COLORADA,7,48,2,57
26, CUCURPE,1,0,6,7
26, CUMPAS,24,10,1,35
26, DIVISADEROS,8,14,0,22
26, EMPALME,0,23,49,72
26, ETCHOJOA,252,11,41,304
26, FRONTERAS,2,6,1,9
26, GRANADOS,0,1,0,1
26, GUAYMAS,480,36,397,913
26, SAN IGNACIO RIO MU,88,0,7,95
26, HERMOSILLO,2053,2242,744,5039
26, HUACHINERA,0,5,0,5
26, HUASABAS,0,3,0,3
26, HUATABAMPO,46,62,188,296
26, HUEPAC,0,10,2,12
26, IMURIS,0,0,0,0
26, MAGDALENA,0,2,19,21
26, MAZATAN,1,3,1,5
26, MOCTEZUMA,1,9,1,11
26, NACO,0,2,0,2
26, NACORI CHICO,46,23,1,70
26, NAVOJOA,430,223,370,1023
26, NOGALES,0,9,0,9
26, ONAVAS,14,13,0,27
26, OPODEPE,0,14,0,14
26, VILLA HIDALGO,0,0,0,0
26, OQUITOA,0,1,0,1
26, PITIQUITO,3,10,0,13
26, PUERTO PENASCO,0,0,8,8
26, QUIRIEGO,16,1,7,24
26, RAYON,0,5,6,11
26, ROSARIO,138,26,2,166
26, SAHUARIPA,27,41,3,71
26, SAN FELIPE,0,1,0,1
26, SAN JAVIER,5,0,0,5
26, SAN LUIS RIO COLOR,267,261,90,618
26, SAN MIGUEL DE HORC,4,5,2,11
26, SAN PEDRO DE LA CU,0,5,0,5
26, SANTA ANA,1,1,1,3
26, SANTA CRUZ,0,0,0,0
26, SARIC,1,6,0,7
26, SOYOPA,13,11,0,24
26, SUAQUI GRANDE,26,10,0,36
26, TEPACHE,0,1,0,1
26, TRINCHERAS,0,1,6,7
26, TUBUTAMA,0,1,0,1
26, URES,14,60,2,76
26, VILLA PESQUEIRA,65,32,1,98
26, YECORA,53,27,4,84
27, BALANCAN,1371,269,39,1679
27, CARDENAS,3737,1290,197,5224
27, CENTLA,27,561,0,588
27, CENTRO,1413,3104,518,5035
27, COMALCALCO,4982,312,23,5317
27, CUNDUACAN,43,142,0,185
27, EMILIANO ZAPATA,1436,1348,67,2851
27, HUIMANGUILLO,1387,373,13,1773
27, JALAPA,0,0,0,0
27, JALPA DE MENDEZ,0,1,1,2
27, JONUTA,2734,167,20,2921
27, MACUSPANA,46,77,57,180
27, NACAJUCA,0,1,0,1
27, PARAISO,0,162,0,162
27, TEAPA TAB,0,360,2,362
27, TENOSIQUE,1052,358,53,1463
27, TACOTALPA TAB,0,0,0,0
28, ABASOLO,346,16,173,535
28, ALDAMA,5,42,215,262
28, ALTAMIRA,3,4,24,31
28, ANTIGUO MORELOS,0,1,0,1
28, BURGOS,2,18,1,21
28, BUSTAMANTE,0,0,0,0
28, CAMARGO,54,16,5,75
28, CASAS,0,0,3,3
28, CIUDAD MADERO,0,0,0,0
28, CRUILLAS,0,1,1,2
28, GUSTAVO DIAZ ORDAZ,87,5,1,93
28, GOMEZ FARIAS,0,0,2,2
28, GONZALEZ,36,11,81,128
28, GUEMEZ,0,0,1,1
28, HIDALGO,3,1,13,17
28, JAUMAVE,0,0,0,0
28, JIMENEZ,0,0,14,14
28, LLERA,0,0,1,1
28, MANTE,1855,2195,252,4302
28, MATAMOROS,640,273,490,1403
28, MENDEZ,5355,41,20,5416
28, MIER,0,0,14,14
28, MIGUEL ALEMAN,0,0,0,0
28, MIQUIHUANA,0,0,0,0
28, NUEVO MORELOS,0,0,0,0
28, OCAMPO,655,416,2,1073
28, PADILLA,0,0,37,37
28, REYNOSA,227,49,505,781
28, RIO BRAVO,3072,167,393,3632
28, SAN CARLOS,0,39,4,43
28, SAN FERNANDO,333,197,229,759
28, SOTO LA MARINA,68,9,28,105
28, TAMPICO,418,302,122,842
28, TULA,0,0,0,0
28, VALLE HERMOSO,871,197,697,1765
28, VICTORIA,191,20,66,277
28, VILLAGRAN,0,0,0,0
28, XICOTENCATL,1177,733,270,2180
29, AMAXAC DE GUERRERO,0,1,0,1
29, ANTONIO CARBAJAL,0,20,0,20
29, ATLANGATEPEC,12,9,2,23
29, ATLZAYANCA,163,41,3,207
29, APIZACO,43,25,8,76
29, CALPULALPAN,761,6,4,771
29, EL CARMEN,82,85,0,167
29, CHIAUTEMPAN,20,17,2,39
29, CUAPIAXTLA,148,20,2,170
29, CUAXOMULCO,7,0,2,9
29, DOMINGO ARENAS,24,10,0,34
29, ESPANITA,14,6,0,20
29, HUAMANTLA,110,238,8,356
29, HUEYOTLIPAN,37,4,0,41
29, IXTACUIXTLA,29,43,0,72
29, IXTENCO,69,0,0,69
29, JUAN CUAMATZI,0,0,1,1
29, LARDIZABAL,0,22,0,22
29, LAZARO CARDENAS,15,27,0,42
29, MARIANO ARISTA,52,15,0,67
29, NATIVITAS,21,19,1,41
29, PANOTLA,10,11,0,21
29, SAN PABLO DEL MONT,0,0,3,3
29, SANTA CRUZ TLAXCAL,4,37,0,41
29, TOCATLAN,10,2,3,15
29, TENANCINGO,8,0,0,8
29, TEPEYANCO,0,0,0,0
29, TERRENATE,15,20,2,37
29, TETLA,9,0,0,9
29, TETLATLAHUACA,17,0,0,17
29, TLAXCALA,22,0,0,22
29, TLAXCO,257,119,22,398
29, TRINIDAD SANCHEZ S,9,8,0,17
29, TZOMPANTEPEC,71,0,0,71
29, XALOZTOC,59,4,0,63
29, XALTOCAN,19,13,0,32
29, XICOHTENCATL,1,8,2,11
29, YAUHQUEMEHCAN,2,1,0,3
29, ZACATELCO,8,2,2,12
30, ACAYUCAN,7982,1722,37,9741
30, ACTOPAN,600,0,1,601
30, ACULA,0,0,0,0
30, ACULTZINGO,0,1,0,1
30, ADALBERTO TEJEDA,0,0,4,4
30, ALTO LUCERO,0,0,0,0
30, ALTOTONGA,0,0,0,0
30, ALVARADO,0,13,0,13
30, AMATITLAN,0,0,5,5
30, AMATLAN DE LOS REY,348,20,7,375
30, AMATLAN DE LOS NAR,0,0,0,0
30, ANGEL R CABADA,0,0,0,0
30, LA ANTIGUA,1928,181,47,2156
30, ATLAHUILCO,0,0,0,0
30, ATOYAC,2334,1025,0,3359
30, ATZACAN,25,0,0,25
30, ATZALAN,391,0,0,391
30, AXOCUAPAN,0,0,0,0
30, AYAHUALULCO,0,0,0,0
30, BENITO JUAREZ,0,0,0,0
30, BOCA DEL RIO,13,23,9,45
30, CAMERINO Z MENDOZA,128,68,0,196
30, CARRILO PUERTO,0,0,0,0
30, CATEMACO,0,0,0,0
30, CAZONES,1265,0,0,1265
30, CERRO AZUL,0,0,0,0
30, CHACALTIANGUIS,0,0,2,2
30, CHALMA,0,0,0,0
30, CHICONAMEL,0,0,0,0
30, CHICONTEPEC,0,0,0,0
30, CHINAMECA,212,0,1,213
30, CHINAMPA DE GOROST,0,0,0,0
30, LAS CHOAPAS,4,10,0,14
30, CHOCAMAN,100,0,0,100
30, CHONTLA,0,0,1,1
30, CHUMATLAN,0,0,0,0
30, COAHUITLAN,0,0,0,0
30, COATEPEC,2027,18,35,2080
30, COATZACOALCOS,48,8,0,56
30, COATZINTLA,3,0,11,14
30, COLIPA,0,0,0,0
30, COSAUTLAN DE CARVA,0,0,0,0
30, COMAPA,0,0,0,0
30, CORDOBA,1545,345,53,1943
30, COSAMALOAPAN,1240,1146,574,2960
30, COSCOMATEPEC,27,65,4,96
30, COSOLEACAQUE,0,0,0,0
30, COTAXTLA,108,0,4,112
30, COXQUIHUI,0,0,0,0
30, COYUTLA,0,0,0,0
30, CUICHAPA,2084,346,8,2438
30, CUITLAHUAC,0,6,4,10
30, EMILIANO ZAPATA,171,0,1,172
30, ESPINAL,0,1,0,1
30, FILOMENO MATA,0,0,0,0
30, FORTIN,0,60,0,60
30, GUTIERREZ ZAMORA,0,12,0,12
30, HIDALGOTITLAN,0,0,1,1
30, HUATUSCO,186,0,8,194
30, HUAYACOCOTLA,0,0,0,0
30, HUEYAPAN DE OCAMPO,1315,590,0,1905
30, HUILOAPAN,0,60,0,60
30, IXCATEPEC,40,0,0,40
30, ISLA,2684,448,27,3159
30, IXHUACAN,42,0,0,42
30, IXHUATLAN DE MADER,0,0,2,2
30, IXHUATLANCILLO,0,0,0,0
30, IXMATLAHUACAN,0,0,0,0
30, IXTACZOQUITLAN,0,13,21,34
30, JALAPA,435,1,53,489
30, JALTIPAN DE MORELO,0,4,0,4
30, JAMAPA,0,0,32,32
30, JESUS CARRANZA,16,7,34,57
30, JICO,2,0,11,13
30, JILOTEPEC,0,0,0,0
30, JUAN RODRIGUEZ CLA,0,0,5,5
30, JUCHIQUE DE FERRER,0,0,2,2
30, LERDO DE TEJADA,1529,1093,4,2626
30, MAGDALENA,0,0,0,0
30, MALTRATA,0,1,0,1
30, MANLIO FABIO ALTAM,32,0,0,32
30, MARIANO ESCOBEDO,0,0,0,0
30, MARTINEZ DE LA TOR,1298,892,28,2218
30, MECATLAN,127,0,0,127
30, MECAYAPAN,0,0,0,0
30, MEDELLIN,0,0,2,2
30, MINATITLAN,0,1,0,1
30, MISANTLA,0,2,2,4
30, MIXTLA DE ALTAMIRA,0,0,0,0
30, NARANJAL,0,0,0,0
30, NAUTLA,0,0,0,0
30, NOGALES,0,0,0,0
30, OLUTA,0,0,0,0
30, OMEALCA,0,55,0,55
30, OTATITLAN,0,0,0,0
30, OZULUAMA,0,1,23,24
30, PANUCO,4227,3190,132,7549
30, PAPANTLA,4985,89,1,5075
30, PASO DE OVEJAS,565,0,2,567
30, PASO DEL MACHO,1235,714,21,1970
30, LA PERLA,0,0,0,0
30, PEROTE,0,0,2,2
30, PLATON SANCHEZ,0,1,49,50
30, PLAYA VICENTE,186,0,0,186
30, POZA RICA DE HIDAL,0,0,0,0
30, PUEBLO VIEJO,0,0,0,0
30, PUENTE NACIONAL,0,0,16,16
30, RAFAEL LUCIO,0,0,6,6
30, REYES,0,0,0,0
30, SAN ANDRES TUXTLA,0,0,0,0
30, SAN JUAN EVANGELIS,1,17,12,30
30, SANTIAGO TUXTLA,0,0,0,0
30, SAYULA,1,28,1,30
30, SOLEDAD ATZOMPA,0,0,0,0
30, SOLEDAD DE DOBLADO,0,6,6,12
30, SOTEAPAN,2086,0,0,2086
30, TAMALIN,0,0,2,2
30, TAMIAHUA,0,0,0,0
30, TAMPICO ALTO,0,0,2,2
30, TANCOCO,1,1,0,2
30, TANTIMA,0,0,0,0
30, TANTOYUCA,0,2,5,7
30, TATATILA,0,0,4,4
30, TEAYO,10,0,0,10
30, TECOLUTLA,0,0,0,0
30, TEHUIPANGO,0,0,0,0
30, TEMAPACHE,98,6,0,104
30, TEMPOAL,0,0,92,92
30, TENAMPA,0,0,0,0
30, RIO BLANCO,0,0,1,1
30, TENOCHTITLAN,0,0,0,0
30, TEOCELO,0,22,10,32
30, TEPATLAXCO,0,0,0,0
30, TEPETZINTLA,0,1,0,1
30, TEQUILA,0,0,0,0
30, JOSE AZUETA,0,3,0,3
30, TEXCATEPEC,0,0,0,0
30, TEXHUACAN,0,0,0,0
30, TEXISTEPEC,52,1,0,53
30, TEZONAPA,5969,3224,469,9662
30, TIERRA BLANCA,804,969,46,1819
30, TIHUATLAN,575,47,0,622
30, TLACHICHILCO,0,0,0,0
30, TLACOJALPAN,0,0,0,0
30, TLACOTALPAN,0,0,0,0
30, TRES VALLES,3281,939,71,4291
30, TLACOTEPEC,0,0,0,0
30, TLALIXCOYAN,144,0,2,146
30, TLAPACOYAN,0,10,30,40
30, TLILAPAN,0,0,0,0
30, TOMATLAN,0,1,8,9
30, TOTUTLA,40,0,0,40
30, TUXPAN,0,0,18,18
30, URSULO GALVAN,4660,823,132,5615
30, VEGA DE ALATORRE,0,9,3,12
30, VERACRUZ,12413,496,17,12926
30, LAS VIGAS DE RAMIR,6,17,15,38
30, VILLA ALDAMA,0,0,0,0
30, XOXOCOTLA,0,0,0,0
30, YANGA,0,0,0,0
30, YECUATLA,0,1,0,1
30, ZACUALPAN,0,0,0,0
30, UXPANAPA,7,6,0,13
30, TATAHUICAPAN DE JU,0,0,0,0
30, ZENTLA,0,0,0,0
30, ZONGOLICA,0,122,0,122
30, ZONTECOMATLAN,0,0,0,0
30, EL HIGO,847,67,2,916
31, ABALA,1,0,0,1
31, ACANCEH,1,0,2,3
31, AKIL,12,0,0,12
31, BOKOBA,0,0,0,0
31, BUCTZOTZ,1,0,0,1
31, CACALCHEN,0,0,0,0
31, CANSAHCAB,0,0,0,0
31, CANTAMAYEC,0,0,0,0
31, CELESTUN,0,0,55,55
31, CENOTILLO,0,0,0,0
31, CHACZINKIN,0,0,0,0
31, CHANKOM,0,0,0,0
31, CHEMAX,39,0,0,39
31, CHICHIMILA,0,0,0,0
31, CHICXULUB,0,0,1,1
31, CHIKINDZONOT,0,0,0,0
31, CHOCHOLA,0,0,0,0
31, CONKAL,0,0,1,1
31, CUNCUNUL,8,0,0,8
31, DZILAM DE BRAVO,0,0,20,20
31, DZILAM GONZALEZ,1,1,0,2
31, DZITAS,0,0,0,0
31, DZONCAUICH,2,0,0,2
31, ESPITA,30,8,0,38
31, HALACHO,0,0,0,0
31, HOCABA,0,0,0,0
31, HOCTUN,0,0,0,0
31, HOMUN,0,0,0,0
31, HUNUCMA,10,0,24,34
31, IZAMAL,191,0,0,191
31, KANASIN,0,4,4,8
31, KANTUNIL,0,0,0,0
31, KAUA,0,1,0,1
31, KINCHIL,0,0,0,0
31, MAMA,0,0,0,0
31, MAXCANU,0,1,0,1
31, MERIDA,4,12,231,247
31, MOCOCHA,0,0,1,1
31, MOTUL,7,0,0,7
31, MUNA,184,0,3,187
31, MUXUPIP,0,0,0,0
31, OXKUTZCAB,407,1,0,408
31, PANABA,2,0,0,2
31, PETO,51,0,0,51
31, PROGRESO,463,832,28,1323
31, QUINTANA ROO,0,0,0,0
31, RIO LAGARTOS,10,0,0,10
31, SACALUM,0,0,0,0
31, SAN FELIPE,0,0,20,20
31, SANTA ELENA,0,0,0,0
31, SEYE,0,0,1,1
31, SUCILA,0,0,0,0
31, SUDZAL,0,2,0,2
31, TAHDZIU,0,0,0,0
31, TAHMEK,0,0,0,0
31, TEKAL DE VENEGAS,5,0,0,5
31, TEKANTO,0,0,0,0
31, TEKAX,112,57,10,179
31, TEKIT,0,0,0,0
31, TECOH,0,0,0,0
31, TEKOM,0,0,0,0
31, TEMAX,0,0,0,0
31, TEMOZON,25,1,2,28
31, TETIZ,0,0,0,0
31, TICUL,180,1,0,181
31, TIMUCUY,0,0,0,0
31, TINUM,40,0,0,40
31, TIXCACALCUPUL,23,0,0,23
31, TIXKOKOB,0,0,1,1
31, TIXMEUAC,0,0,0,0
31, TIXPEUAL,10,0,0,10
31, TIZIMIN,393,10,4,407
31, TUNKAS,0,0,0,0
31, TZUCACAB,36,6,1,43
31, UAYMA,0,0,0,0
31, UMAN,0,5,30,35
31, VALLADOLID,2501,45,18,2564
31, YAXCABA,0,0,0,0
31, YOBAIN,0,0,0,0
32, APULCO,0,0,0,0
32, ATOLINGA,0,0,0,0
32, BENITO JUAREZ,50,5,1,56
32, CALERA,197,107,19,323
32, CANITAS DE FELIPE ,12,1,0,13
32, CHALCHIHUITES,0,1,6,7
32, CONCEPCION DEL ORO,0,0,0,0
32, CUAUHTEMOC,0,0,0,0
32, EL SALVADOR,0,0,0,0
32, FRESNILLO,3533,357,62,3952
32, GENERAL ENRIQUE ES,1,1,4,6
32, GENARO CODINA,344,0,0,344
32, GENERAL FRANCISCO ,274,3,2,279
32, GENERAL PANFILO NA,98,0,0,98
32, GUADALUPE,616,24,4,644
32, JALPA,105,0,0,105
32, JEREZ,226,97,2,325
32, JIMENEZ DEL TEUL,0,9,0,9
32, JUAN ALDAMA,228,4,6,238
32, LORETO,383,381,21,785
32, LUIS MOYA,1,2,5,8
32, MAZAPIL,710,1,3,714
32, MELCHOR OCAMPO,0,0,0,0
32, MEZQUITAL DEL ORO,0,0,0,0
32, MIGUEL AUZA,6015,44,7,6066
32, MOMAX,143,53,0,196
32, MONTE ESCOBEDO,333,14,16,363
32, MORELOS,900,0,5,905
32, NOCHISTLAN DE MEJI,0,0,0,0
32, NORIA DE ANGELES,4,0,0,4
32, OJOCALIENTE,485,28,3,516
32, PANUCO,1327,80,1,1408
32, PINOS,1187,19,0,1206
32, RIO GRANDE,586,173,5,764
32, SAIN ALTO,68,90,2,160
32, SOMBRERETE,1061,46,23,1130
32, SUSTICACAN,0,0,0,0
32, TABASCO,0,0,0,0
32, TEPECHITLAN,0,10,5,15
32, TEPETONGO,0,0,0,0
32, TEUL DE GONZALEZ O,0,0,1,1
32, TLALTENANGO DE SAN,301,17,2,320
32, VALPARAISO,0,11,0,11
32, VETAGRANDE,7,4,2,13
32, VILLA DE COS,1991,13,18,2022
32, VILLA GARCIA,508,11,0,519
32, VILLA GONZALEZ ORT,0,2,0,2
32, VILLA HIDALGO,287,0,0,287
32, VILLANUEVA,202,137,1,340
32, TRANCOSO,7,0,0,7
32, ZACATECAS,864,1,1,866
