cve_edo,Municipio,PD1,PD2,PD3,Total
1,3    AGUASCALIENTES,456,1426,2315,4197
1,6    ASIENTOS,0,37,0,37
1,9    CALVILLO,516,218,13,747
1,12   COSIO,0,25,5,30
1,15   JESUS MARIA,205,212,15,432
1,17   PABELLON DE ARTEAGA,41,10,31,82
1,18   RINCON DE ROMOS,62,119,10,191
1,21   SAN JOSE DE GRACIA,1,16,0,17
1,24   TEPEZALA,0,24,0,24
1,29   EL LLANO,553,21,3,577
1,31   SAN FRANCISCO DE LOS ROMO,426,187,96,709
2,27   ENSENADA,755,390,288,1433
2,30   MEXICALI,2365,2489,2495,7349
2,33   TECATE,0,153,31,184
2,36   TIJUANA,44,149,23,216
3,38   LOS CABOS,1564,181,73,1818
3,39   COMONDU,384,514,121,1019
3,42   MULEGE,552,176,15,743
3,45   LA PAZ,402,141,211,754
3,49   LORETO,99,36,6,141
4,60   CALKINI,5128,3027,65,8220
4,63   CAMPECHE,736,3549,119,4404
4,66   CARMEN,700,2633,49,3382
4,69   CHAMPOTON,915,2330,99,3344
4,70   ESCARCEGA,4159,724,81,4964
4,72   HECELCHAKAN,164,65,18,247
4,73   CANDELARIA,170,190,0,360
4,75   HOPELCHEN,912,283,118,1313
4,78   PALIZADA,84,31,113,228
4,79   CALAKMUL,417,0,20,437
4,81   TENABO,110,21,9,140
7,84   ACACOYAGUA,272,1,0,273
7,87   ACALA,245,126,0,371
7,90   ACAPETAHUA,137,25,9,171
7,93   ALTAMIRANO,119,0,0,119
7,96   AMATAN,1,1,0,2
7,99   AMATENANGO DE LA FRONTERA,113,7,4,124
7,102  AMATENANGO DEL VALLE,2,0,0,2
7,105  JALTENANGO,973,148,4,1125
7,108  ARRIAGA,176,3636,11,3823
7,111  BEJUCAL DE OCAMPO,15,0,0,15
7,114  BELLA VISTA,80,0,0,80
7,117  BERRIOZABAL,192,40,2,234
7,120  BOCHIL,310,4,1,315
7,123  EL BOSQUE,482,0,0,482
7,126  CACAHOATAN,482,46,2,530
7,129  CATAZAJA,117,45,26,188
7,141  CHAPULTENANGO,11,1,0,12
7,144  CHENALHO,495,0,0,495
7,147  CHIAPA DE CORZO,6585,7234,4,13823
7,150  CHIAPILLA,102,0,0,102
7,153  CHICOASEN,33,2,0,35
7,156  CHICOMUSELO,249,9,3,261
7,159  CHILON,161,20,2,183
7,162  CINTALAPA,3000,587,8,3595
7,165  COAPILLA,17,10,0,27
7,168  COMITAN DE DOMINGUEZ,3389,7550,31,10970
7,171  LA CONCORDIA,1808,98,160,2066
7,174  COPAINALA,79,2,0,81
7,177  ESCUINTLA,595,48,0,643
7,183  FRONTERA COMALAPA,7143,539,52,7734
7,186  FRONTERA HIDALGO,3,0,0,3
7,189  LA GRANDEZA,14,0,0,14
7,195  HUEHUETAN,0,2,7,9
7,201  HUITIUPAN,1058,0,0,1058
7,204  HUIXTLA,4830,4288,18,9136
7,207  LA INDEPENDENCIA,1237,103,0,1340
7,210  IXHUATAN,24,3,0,27
7,213  IXTACOMITAN,3,9,0,12
7,216  IXTAPA,245,59,1,305
7,219  IXTAPANGAJOYA,2,0,0,2
7,222  JIQUIPILAS,693,17,0,710
7,225  JITOTOL,128,30,0,158
7,228  JUAREZ,31,50,2,83
7,231  LARRAINZAR,55,0,0,55
7,234  LA LIBERTAD,10,3,1,14
7,237  MAPASTEPEC,5180,465,86,5731
7,240  LAS MARGARITAS,654,9,12,675
7,243  MAZAPA DE MADERO,0,0,0,0
7,246  MAZATAN,436,11,20,467
7,254  MOTOZINTLA,962,23,4,989
7,255  NICOLAS RUIZ,62,1,0,63
7,258  OCOSINGO,4674,311,28,5013
7,261  OCOTEPEC,7,0,0,7
7,264  OCOZOCOAUTLA DE ESPINOSA,1848,4173,2,6023
7,267  OSTUACAN,71,92,3,166
7,270  OXCHUC,21,0,0,21
7,273  OSUMACINTA,3,2,0,5
7,276  PALENQUE,2349,2562,23,4934
7,285  PICHUCALCO,15,64,8,87
7,288  PIJIJIAPAN,1671,3699,53,5423
7,294  VILLA COMALTITLAN,63,0,0,63
7,297  PUEBLO NUEVO SOLISTAHUACAN,27,3,0,30
7,300  RAYON,52,19,0,71
7,303  REFORMA,30,42,2,74
7,306  LAS ROSAS,26,1,0,27
7,309  SABANILLA,0,5,0,5
7,312  SALTO DE AGUA,67,118,4,189
7,315  SAN CRISTOBAL DE LAS CASAS,141,3631,1,3773
7,318  SAN FERNANDO,621,42,0,663
7,321  SILTEPEC,143,0,0,143
7,324  SIMOJOVEL,2661,0,0,2661
7,330  SOCOLTENANGO,2925,10,2,2937
7,333  SOLOSUCHIAPA,30,3,0,33
7,336  SOYALO,99,34,0,133
7,339  SUCHIAPA,309,203,1,513
7,342  SUCHIATE,1,19,6,26
7,345  SUNUAPA,1,8,1,10
7,348  TAPACHULA,1758,8211,256,10225
7,351  TAPALAPA,2,0,0,2
7,354  TAPILULA,82,33,0,115
7,357  TECPATAN,365,46,0,411
7,360  TENEJAPA,7,0,0,7
7,363  TEOPISCA,107,4,0,111
7,369  TILA,2,132,0,134
7,372  TONALA,6524,9136,214,15874
7,375  TOTOLAPA,35,0,0,35
7,378  LA TRINITARIA,330,8,2,340
7,381  TUMBALA,10,13,0,23
7,384  TUXTLA GUTIERREZ,8672,9986,502,19160
7,387  TUXTLA CHICO,22,0,85,107
7,390  TUZANTAN,3,55,0,58
7,393  TZIMOL,29,0,0,29
7,399  VENUSTIANO CARRANZA,4843,1560,8,6411
7,402  ANGEL ALBINO CORZO,1677,182,64,1923
7,405  VILLAFLORES,13971,12023,243,26237
7,408  YAJALON,174,326,2,502
7,411  SAN LUCAS,171,0,0,171
7,414  ZINACANTAN,16,0,0,16
8,417  ALDAMA,25,32,23,80
8,420  ALLENDE,18,3,5,26
8,426  ASCENSION,309,52,23,384
8,429  BACHINIVA,13,0,18,31
8,432  BALLEZA,218,3,2,223
8,438  BOCOYNA,0,0,0,0
8,441  BUENAVENTURA,81,403,130,614
8,444  CAMARGO,106,82,42,230
8,447  CARICHI,65,0,0,65
8,450  CASAS GRANDES,117,5,12,134
8,453  CHIHUAHUA,5257,859,182,6298
8,462  LA CRUZ,0,3,0,3
8,465  CUAUHTEMOC,450,4175,899,5524
8,468  CUSIHUIRIACHI,104,3,7,114
8,471  DELICIAS,234,701,421,1356
8,480  GALEANA,8,1,1,10
8,483  SANTA ISABEL,7,3,0,10
8,486  GOMEZ FARIAS,27,0,2,29
8,489  GRAN MORELOS,1,0,0,1
8,490  GUACHOCHI,375,0,1,376
8,492  GUADALUPE,0,0,1,1
8,495  GUADALUPE Y CALVO,172,16,1,189
8,498  GUAZAPARES,111,0,0,111
8,501  GUERRERO,141,1,15,157
8,504  HIDALGO DEL PARRAL,506,495,92,1093
8,510  IGNACIO ZARAGOZA,19,0,0,19
8,513  JANOS,2,28,4,34
8,516  JIMENEZ,14,87,50,151
8,519  JUAREZ,33,776,244,1053
8,522  JULIMES,17,11,2,30
8,525  MADERA,596,32,7,635
8,534  MATACHI,18,0,0,18
8,537  MEOQUI,44,59,22,125
8,540  MORELOS,0,5,0,5
8,546  NAMIQUIPA,345,118,127,590
8,552  NUEVO CASAS GRANDES,16,60,47,123
8,558  OJINAGA,0,181,195,376
8,561  PRAXEDIS G. GUERRERO,0,0,5,5
8,564  RIVA PALACIO,162,0,1,163
8,567  ROSALES,2,21,4,27
8,570  ROSARIO,1,0,0,1
8,573  SAN FRANCISCO DE BORJA,0,0,1,1
8,576  SAN FRANCISCO DE CONCHOS,17,7,5,29
8,579  SAN FRANCISCO DEL ORO,0,1,0,1
8,582  SANTA BARBARA,13,0,0,13
8,585  SATEVO,8,2,9,19
8,588  SAUCILLO,45,163,46,254
8,591  TEMOSACHIC,23,0,1,24
8,594  URIQUE,7,0,0,7
8,600  AHUMADA,32,22,58,112
8,603  CORONADO,12,15,4,31
8,606  LOPEZ,22,16,4,42
8,609  MATAMOROS,0,29,23,52
8,612  VALLE DE ZARAGOZA,90,10,9,109
5,618  ACUÑA,0,2,1,3
5,621  ALLENDE,0,914,0,914
5,624  ARTEAGA,8,2,34,44
5,633  CUATRO CIENEGAS,0,3,0,3
5,642  GENERAL CEPEDA,38,1,15,54
5,645  GUERRERO,0,0,2,2
5,648  HIDALGO,0,4,0,4
5,651  JIMENEZ,8,0,0,8
5,660  MATAMOROS,250,7640,68,7958
5,663  MONCLOVA,0,3576,0,3576
5,669  MUZQUIZ,0,0,5,5
5,672  NADADORES,0,3,0,3
5,678  OCAMPO,0,4,4,8
5,681  PARRAS,303,50,7,360
5,687  PROGRESO,0,0,1,1
5,690  RAMOS ARIZPE,0,1,94,95
5,693  SABINAS,0,3570,3,3573
5,699  SALTILLO,522,4189,248,4959
5,702  SAN BUENAVENTURA,0,0,6,6
5,705  SAN JUAN DE SABINAS,0,3,9,12
5,714  TORREON,14211,4413,1091,19715
5,720  FRONTERA,10,0,4,14
5,2781 GALEANA,43,0,192,235
6,728  ARMERIA,557,983,0,1540
6,729  COLIMA,1435,286,224,1945
6,732  COMALA,1189,835,0,2024
6,735  COQUIMATLAN,202,28,0,230
6,738  CUAUHTEMOC,4458,868,244,5570
6,741  IXTLAHUACAN,2,0,0,2
6,744  MANZANILLO,185,224,100,509
6,747  MINATITLAN,0,213,0,213
6,750  TECOMAN,1887,1015,68,2970
6,753  VILLA DE ALVAREZ,0,1,1,2
9,756  AZCAPOTZALCO,13,0,134,147
9,759  CIUDAD DE MEXICO,0,0,118,118
9,760  MIGUEL HIDALGO,0,2,103,105
9,762  COYOACAN,0,0,17,17
9,765  CUAJIMALPA DE MORELOS,1,1,101,103
9,768  GUSTAVO A. MADERO,0,7,0,7
9,774  IZTAPALAPA,0,0,151,151
9,775  CUAUHTEMOC,0,0,6,6
9,780  MILPA ALTA,1,527,0,528
9,783  ALVARO OBREGON,0,1,65,66
9,785  BENITO JUAREZ,0,0,130,130
9,786  TLAHUAC,0,47,0,47
9,789  TLALPAN,0,47,71,118
9,792  XOCHIMILCO,0,6235,0,6235
10,639  FRANCISCO I. MADERO,0,0,18,18
10,708  SAN PEDRO,28,0,5,33
10,795  CANATLAN,552,2152,0,2704
10,798  CANELAS,0,3,4,7
10,801  CONETO DE COMONFORT,142,2,0,144
10,804  CUENCAME,2,50,7,59
10,807  DURANGO,11370,2310,351,14031
10,810  GENERAL SIMON BOLIVAR,0,5,0,5
10,813  GOMEZ PALACIO,87,2331,391,2809
10,816  GUADALUPE VICTORIA,235,121,61,417
10,819  GUANACEVI,712,4,1,717
10,822  HIDALGO,137,3,3,143
10,825  INDE,0,3,8,11
10,828  LERDO,90,2148,60,2298
10,831  MAPIMI,208,41,54,303
10,834  MEZQUITAL,0,4,0,4
10,837  NAZAS,68,28,1,97
10,840  NOMBRE DE DIOS,91,7,3,101
10,843  OCAMPO,201,14,2,217
10,846  EL ORO,0,1,10,11
10,849  OTAEZ,3,0,0,3
10,852  PANUCO DE CORONADO,2,17,4,23
10,855  PEÑON BLANCO,5,15,0,20
10,858  POANAS,255,177,4,436
10,861  PUEBLO NUEVO,0,1,0,1
10,864  RODEO,0,0,14,14
10,870  SAN DIMAS,36,4,0,40
10,876  SAN JUAN DEL RIO,246,0,0,246
10,885  SANTA CLARA,1,5,0,6
10,888  SANTIAGO PAPASQUIARO,41398,1427,39,42864
10,891  SUCHIL,1,3,0,4
10,894  TAMAZULA,204,0,0,204
10,897  TEPEHUANES,3,9,3,15
10,900  TLAHUALILO,0,12,9,21
10,903  TOPIA,3,0,0,3
10,905  NUEVO IDEAL,802,12,19,833
10,906  VICENTE GUERRERO,526,16,0,542
11,909  ABASOLO,1357,208,162,1727
11,912  ACAMBARO,308,250,15,573
11,915  SAN MIGUEL DE ALLENDE,0,13,0,13
11,918  APASEO EL ALTO,239,627,0,866
11,921  APASEO EL GRANDE,6,29,48,83
11,927  MANUEL DOBLADO,980,459,10,1449
11,930  CELAYA,1873,1458,369,3700
11,933  COMONFORT,300,117,6,423
11,939  CORTAZAR,174,100,97,371
11,942  CUERAMARO,10,16,1,27
11,945  DOLORES HIDALGO,732,738,33,1503
11,948  DOCTOR MORA,9,6,5,20
11,951  GUANAJUATO,7,299,1,307
11,954  HUANIMARO,1671,265,11,1947
11,957  IRAPUATO,661,1121,1421,3203
11,960  JARAL DEL PROGRESO,1077,72,41,1190
11,963  JERECUARO,0,4,1,5
11,966  LEON,549,1041,425,2015
11,969  MOROLEON,966,0,5,971
11,972  OCAMPO,285,25,0,310
11,975  PENJAMO,2683,1171,795,4649
11,978  PUEBLO NUEVO,251,373,43,667
11,981  PURISIMA DEL RINCON,125,61,306,492
11,984  ROMITA,256,232,14,502
11,987  SAN DIEGO DE LA UNION,205,0,0,205
11,990  SAN FRANCISCO DEL RINCON,145,320,11,476
11,993  SAN JOSE ITURBIDE,111,172,6,289
11,996  SAN LUIS DE LA PAZ,257,1204,28,1489
11,999  SALAMANCA,894,1018,235,2147
11,1002 SALVATIERRA,698,496,100,1294
11,1005 SAN FELIPE,1114,110,11,1235
11,1011 SANTIAGO MARAVATIO,0,1,22,23
11,1014 SILAO,118,374,61,553
11,1017 SANTA CRUZ DE JUVENTINO ROSAS,118,2,9,129
11,1020 TARANDACUAO,169,13,0,182
11,1023 TARIMORO,532,71,4,607
11,1029 URIANGATO,889,2,5,896
11,1032 VALLE DE SANTIAGO,2027,634,180,2841
11,1038 VILLAGRAN,77,98,68,243
11,1044 YURIRIA,1331,4,70,1405
12,1047 ACAPULCO DE JUAREZ,539,6029,45,6613
12,1053 AJUCHITLAN DEL PROGRESO,46,0,0,46
12,1056 ALCOZAUCA DE GUERRERO,80,0,0,80
12,1059 ALPOYECA,10,0,0,10
12,1062 APAXTLA,465,0,0,465
12,1065 ARCELIA,176,17,1,194
12,1074 ATLIXTAC,1028,0,0,1028
12,1077 ATOYAC DE ALVAREZ,1932,256,0,2188
12,1080 AYUTLA DE LOS LIBRES,4,0,0,4
12,1083 AZOYU,282,0,0,282
12,1086 BENITO JUAREZ,13,0,0,13
12,1089 BUENAVISTA DE CUELLAR,94,43,0,137
12,1092 CHILAPA DE ALVAREZ,1341,1836,0,3177
12,1095 CHILPANCINGO DE LOS BRAVO,691,1985,43,2719
12,1098 COAHUAYUTLA DE JOSE MARIA IZAZAGA,764,11,1,776
12,1101 COCULA,79,0,0,79
12,1107 COPALILLO,867,0,0,867
12,1110 COPANATOYAC,1214,0,0,1214
12,1113 COYUCA DE BENITEZ,31,1506,0,1537
12,1116 COYUCA DE CATALAN,65,0,0,65
12,1119 CUAJINICUILAPA,64,130,1,195
12,1131 CUTZAMALA DE PINZON,33,0,1,34
12,1143 HUAMUXTITLAN,11,3,1,15
12,1146 HUITZUCO DE LOS FIGUEROA,1243,9,2,1254
12,1149 IGUALA DE LA INDEPENDENCIA,1049,3112,41,4202
12,1152 IGUALAPA,13,0,0,13
12,1155 IXCATEOPAN DE CUAUHTEMOC,214,5,0,219
12,1158 ZIHUATANEJO DE AZUETA,122,3157,5,3284
12,1161 JUAN R. ESCUDERO,8,0,0,8
12,1164 LEONARDO BRAVO,0,1792,0,1792
12,1167 MALINALTEPEC,305,0,0,305
12,1170 MARTIR DE CUILAPAN,17,9,0,26
12,1173 METLATONOC,1773,0,0,1773
12,1176 MOCHITLAN,60,4,0,64
12,1179 OLINALA,3,0,0,3
12,1182 OMETEPEC,1670,0,0,1670
12,1188 PETATLAN,31,4,0,35
12,1191 PILCAYA,1,20,0,21
12,1194 PUNGARABATO,2777,56,2,2835
12,1197 QUECHULTENANGO,193,8,0,201
12,1200 SAN LUIS ACATLAN,3458,0,0,3458
12,1203 SAN MARCOS,606,0,14,620
12,1206 SAN MIGUEL TOTOLAPAN,47,0,0,47
12,1209 TAXCO DE ALARCON,614,1683,0,2297
12,1212 TECOANAPA,28,0,0,28
12,1215 TECPAN DE GALEANA,836,1571,5,2412
12,1218 TELOLOAPAN,354,84,0,438
12,1221 TEPECOACUILCO DE TRUJANO,1055,0,0,1055
12,1224 TETIPAC,9,0,0,9
12,1227 TIXTLA DE GUERRERO,185,26,6,217
12,1230 TLACOACHISTLAHUACA,849,0,1,850
12,1236 TLALCHAPA,1,0,0,1
12,1242 TLAPA DE COMONFORT,57,1545,2,1604
12,1245 TLAPEHUALA,124,0,0,124
12,1248 LA UNION DE ISIDORO MONTES DE OCA,591,25,4,620
12,1254 XOCHIHUEHUETLAN,265,0,0,265
12,1257 XOCHISTLAHUACA,877,0,0,877
12,1260 ZAPOTITLAN TABLAS,254,0,0,254
12,1263 ZIRANDARO,0,3,0,3
12,1266 ZITLALA,7,10,0,17
12,1269 EDUARDO NERI,237,7,0,244
13,1272 ACATLAN,23,5,4,32
13,1275 ACAXOCHITLAN,15,15,6,36
13,1278 ACTOPAN,29,1204,17,1250
13,1281 AGUA BLANCA DE ITURBIDE,620,0,1,621
13,1284 AJACUBA,0,4,0,4
13,1287 ALFAJAYUCAN,17,0,2,19
13,1290 ALMOLOYA,36,12,0,48
13,1293 APAN,2413,283,14,2710
13,1299 ATITALAQUIA,0,5,3,8
13,1302 ATLAPEXCO,0,6,0,6
13,1305 ATOTONILCO EL GRANDE,0,0,2,2
13,1311 CALNALI,1046,0,0,1046
13,1314 CARDONAL,0,0,3,3
13,1317 CHAPANTONGO,0,0,1,1
13,1323 CHILCUAUTLA,2,0,0,2
13,1326 CUAUTEPEC DE HINOJOSA,36,403,0,439
13,1332 EMILIANO ZAPATA,25,47,0,72
13,1335 EPAZOYUCAN,6,44,2,52
13,1338 FRANCISCO I. MADERO,1,7,1,9
13,1341 HUASCA DE OCAMPO,1,8,1,10
13,1344 HUAUTLA,0,2,1,3
13,1347 HUAZALINGO,0,4,0,4
13,1350 HUEHUETLA,0,5,0,5
13,1353 HUEJUTLA DE REYES,529,269,4,802
13,1356 HUICHAPAN,222,0,1,223
13,1359 IXMIQUILPAN,552,3131,8,3691
13,1365 JALTOCAN,0,5,0,5
13,1374 METEPEC,154,12,43,209
13,1377 SAN AGUSTIN METZQUITITLAN,0,1,0,1
13,1380 METZTITLAN,58,4,6,68
13,1383 MINERAL DE LA REFORMA,2436,431,10,2877
13,1386 MINERAL DEL CHICO,1,4,0,5
13,1395 MIXQUIAHUALA DE JUAREZ,504,35,16,555
13,1410 SAN FELIPE ORIZATLAN,0,17,0,17
13,1413 PACHUCA DE SOTO,30,2332,7,2369
13,1420 PROGRESO DE OBREGON,3,9,5,17
13,1422 SAN AGUSTIN TLAXIACA,400,145,1,546
13,1425 SAN BARTOLO TUTOTEPEC,1,2,0,3
13,1428 SAN SALVADOR,9,22,3,34
13,1431 SANTIAGO DE ANAYA,0,23,0,23
13,1434 SANTIAGO TULANTEPEC DE LUGO GUERRERO,0,21,0,21
13,1437 SINGUILUCAN,54,30,2,86
13,1440 TASQUILLO,0,15,2,17
13,1443 TECOZAUTLA,100,13,11,124
13,1449 TEPEAPULCO,4,102,1,107
13,1455 TEPEJI DEL RIO DE OCAMPO,6,1,11,18
13,1458 TEPETITLAN,0,0,1,1
13,1464 TEZONTEPEC DE ALDAMA,550,2,1,553
13,1467 VILLA DE TEZONTEPEC,13,7,12,32
13,1470 TIANGUISTENGO,0,24,0,24
13,1473 TIZAYUCA,48,101,108,257
13,1474 TLAHUELILPAN,0,0,5,5
13,1479 TLANALAPA,0,19,0,19
13,1482 TLANCHINOL,0,1,0,1
13,1485 TLAXCOAPAN,361,0,16,377
13,1488 TOLCAYUCA,537,38,61,636
13,1491 TULA DE ALLENDE,1546,2119,6,3671
13,1494 TULANCINGO DE BRAVO,1031,1325,47,2403
13,1503 YAHUALICA,1,0,0,1
13,1506 ZACUALTIPAN DE ANGELES,0,41,0,41
13,1509 ZAPOTLAN DE JUAREZ,194,43,28,265
13,1512 ZEMPOALA,20,79,2,101
13,1515 ZIMAPAN,0,0,16,16
14,1518 ACATIC,74,48,75,197
14,1521 ACATLAN DE JUAREZ,1486,0,4,1490
14,1524 AHUALULCO DE MERCADO,509,11,1,521
14,1527 AMACUECA,6,0,3,9
14,1530 AMATITAN,153,32,0,185
14,1533 AMECA,5869,1263,168,7300
14,1536 SAN JUANITO DE ESCOBEDO,42,0,0,42
14,1539 ARANDAS,43,26,67,136
14,1542 EL ARENAL,164,0,52,216
14,1545 ATEMAJAC DE BRIZUELA,138,10,1,149
14,1548 ATENGO,80,6,13,99
14,1551 ATENGUILLO,634,0,0,634
14,1554 ATOTONILCO EL ALTO,127,16,47,190
14,1557 ATOYAC,70,0,1,71
14,1560 AUTLAN DE NAVARRO,1895,12,12,1919
14,1563 AYOTLAN,0,18,10,28
14,1566 AYUTLA,123,0,2,125
14,1569 LA BARCA,1549,1003,442,2994
14,1578 CASIMIRO CASTILLO,440,37,6,483
14,1581 CHAPALA,1,1,0,2
14,1587 CHIQUILISTLAN,94,3,0,97
14,1590 CIHUATLAN,581,0,1,582
14,1593 ZAPOTLAN EL GRANDE,282,41,194,517
14,1596 COCULA,402,69,36,507
14,1599 COLOTLAN,378,3,0,381
14,1602 CONCEPCION DE BUENOS AIRES,23,2,0,25
14,1605 CUAUTITLAN DE GARCIA BARRAGAN,145,12,4,161
14,1608 CUAUTLA,3,0,0,3
14,1611 CUQUIO,4178,69,6,4253
14,1614 DEGOLLADO,128,0,1,129
14,1620 ENCARNACION DE DIAZ,44,16,34,94
14,1623 ETZATLAN,1837,555,83,2475
14,1626 EL GRULLO,739,8,1,748
14,1629 GUACHINANGO,547,0,0,547
14,1632 GUADALAJARA,130,1721,327,2178
14,1635 HOSTOTIPAQUILLO,13,14,7,34
14,1638 HUEJUCAR,65,2,0,67
14,1641 HUEJUQUILLA EL ALTO,143,0,2,145
14,1644 LA HUERTA,802,2,2,806
14,1647 IXTLAHUACAN DE LOS MEMBRILLOS,87,31,4,122
14,1650 IXTLAHUACAN DEL RIO,323,567,17,907
14,1656 JALOSTOTITLAN,68,58,3,129
14,1659 JAMAY,2798,496,28,3322
14,1662 JESUS MARIA,0,0,21,21
14,1665 JILOTLAN DE LOS DOLORES,387,5,10,402
14,1668 JOCOTEPEC,88,45,0,133
14,1671 JUANACATLAN,5,0,1,6
14,1674 JUCHITLAN,238,0,0,238
14,1677 LAGOS DE MORENO,1005,147,21,1173
14,1683 MAGDALENA,0,1,12,13
14,1686 SANTA MARIA DEL ORO,33,0,0,33
14,1692 MASCOTA,0,2,1,3
14,1698 MEZQUITIC,56,0,0,56
14,1704 OCOTLAN,179,68,72,319
14,1707 OJUELOS DE JALISCO,127,6,1,134
14,1710 PIHUAMO,63,33,7,103
14,1713 PONCITLAN,761,232,11,1004
14,1716 PUERTO VALLARTA,0,582,20,602
14,1719 VILLA PURIFICACION,385,2,0,387
14,1722 QUITUPAN,66,0,0,66
14,1728 SAN DIEGO DE ALEJANDRIA,0,0,1,1
14,1731 SAN JUAN DE LOS LAGOS,258,555,17,830
14,1734 GOMEZ FARIAS,25,0,3,28
14,1737 EL SALTO,18,40,0,58
14,1740 SAN JULIAN,1058,1,66,1125
14,1743 SAN MARCOS,1,0,0,1
14,1749 SAN MARTIN HIDALGO,1219,84,0,1303
14,1752 SAN MIGUEL EL ALTO,166,14,0,180
14,1755 SAN SEBASTIAN DEL OESTE,141,26,0,167
14,1761 SAYULA,487,69,49,605
14,1764 TALA,3008,652,14,3674
14,1770 TAMAZULA DE GORDIANO,2838,324,7,3169
14,1773 TAPALPA,707,67,29,803
14,1776 TECALITLAN,578,17,4,599
14,1779 TECHALUTA DE MONTENEGRO,12,0,1,13
14,1782 TECOLOTLAN,113,0,0,113
14,1785 TENAMAXTLAN,331,10,2,343
14,1788 TEOCALTICHE,307,0,52,359
14,1791 TEOCUITATLAN DE CORONA,7,2,4,13
14,1794 TEPATITLAN DE MORELOS,995,123,185,1303
14,1797 TEQUILA,164,38,18,220
14,1800 TEUCHITLAN,10,0,0,10
14,1806 TLAJOMULCO DE ZUÑIGA,3176,803,22,4001
14,1809 TLAQUEPAQUE,1,547,11,559
14,1812 TOLIMAN,270,148,1,419
14,1815 TOMATLAN,527,64,2,593
14,1818 TONALA,0,647,5,652
14,1821 TONAYA,68,0,0,68
14,1824 TONILA,730,139,20,889
14,1830 TOTOTLAN,683,142,142,967
14,1833 TUXCACUESCO,34,0,0,34
14,1836 TUXCUECA,2,0,0,2
14,1839 TUXPAN,198,20,3,221
14,1842 UNION DE SAN ANTONIO,368,0,11,379
14,1845 UNION DE TULA,203,0,1,204
14,1848 VALLE DE GUADALUPE,83,0,0,83
14,1854 SAN GABRIEL,311,13,7,331
14,1857 VILLA CORONA,5,0,0,5
14,1860 VILLA GUERRERO,12,0,1,13
14,1863 VILLA HIDALGO,125,35,0,160
14,1866 CAÑADAS DE OBREGON,0,0,2,2
14,1869 YAHUALICA DE GONZALEZ GALLO,1,0,0,1
14,1872 ZACOALCO DE TORRES,49,2,0,51
14,1875 ZAPOPAN,7,561,444,1012
14,1878 ZAPOTILTIC,6,2,1,9
14,1881 ZAPOTITLAN DE VADILLO,189,32,0,221
14,1884 ZAPOTLAN DEL REY,146,263,15,424
14,1887 ZAPOTLANEJO,58,535,13,606
15,1890 ACAMBAY,353,36,1,390
15,1893 ACOLMAN,1,364,0,365
15,1896 ACULCO,25,4,0,29
15,1899 ALMOLOYA DE ALQUISIRAS,1,4,0,5
15,1902 ALMOLOYA DE JUAREZ,76,412,4,492
15,1905 ALMOLOYA DEL RIO,0,22,0,22
15,1908 AMANALCO,278,2,1,281
15,1911 AMATEPEC,0,4,0,4
15,1914 AMECAMECA,1,298,295,594
15,1917 APAXCO,0,1,0,1
15,1920 ATENCO,42,217,0,259
15,1923 ATIZAPAN,1,24,0,25
15,1926 ATLACOMULCO,4437,963,0,5400
15,1929 ATLAUTLA,0,110,1,111
15,1932 AXAPUSCO,1676,37,2,1715
15,1935 AYAPANGO,1,63,3,67
15,1938 CALIMAYA,460,99,0,559
15,1941 CAPULHUAC,0,60,0,60
15,1944 CHALCO,26,1646,6,1678
15,1947 CHAPA DE MOTA,1,2,0,3
15,1950 CHAPULTEPEC,0,659,0,659
15,1953 CHIAUTLA,75,481,0,556
15,1956 CHICOLOAPAN,0,3,0,3
15,1959 CHICONCUAC,0,22643,0,22643
15,1962 CHIMALHUACAN,0,563,0,563
15,1965 COACALCO DE BERRIOZABAL,3,2,0,5
15,1968 COATEPEC HARINAS,2,18,0,20
15,1971 COCOTITLAN,0,290,0,290
15,1974 COYOTEPEC,13,56,0,69
15,1977 CUAUTITLAN,1,2,0,3
15,1979 CUAUTITLAN IZCALLI,9,453,29,491
15,1980 DONATO GUERRA,0,9,0,9
15,1983 ECATEPEC DE MORELOS,18,589,0,607
15,1986 ECATZINGO,1,65,0,66
15,1989 HUEHUETOCA,19,209,0,228
15,1992 HUEYPOXTLA,5,26,0,31
15,1995 HUIXQUILUCAN,3,1784,4,1791
15,1998 ISIDRO FABELA,94,31,0,125
15,2001 IXTAPALUCA,0,1278,0,1278
15,2004 IXTAPAN DE LA SAL,2,29,0,31
15,2007 IXTAPAN DEL ORO,0,1,0,1
15,2010 IXTLAHUACA,1376,2432,0,3808
15,2013 XALATLACO,1,76,0,77
15,2016 JALTENCO,2,65,0,67
15,2019 JILOTEPEC,6,16,2,24
15,2022 JILOTZINGO,1,0,0,1
15,2025 JIQUIPILCO,321,449,0,770
15,2028 JOCOTITLAN,705,201,0,906
15,2031 JOQUICINGO,3,13,1,17
15,2034 JUCHITEPEC,36,281,2,319
15,2037 LERMA,179,1399,9,1587
15,2040 MALINALCO,10,41,0,51
15,2043 MELCHOR OCAMPO,25,1,0,26
15,2046 METEPEC,0,3,0,3
15,2049 MEXICALTZINGO,0,25,0,25
15,2052 MORELOS,93,28,0,121
15,2055 NAUCALPAN DE JUAREZ,0,0,25,25
15,2057 NEZAHUALCOYOTL,0,456,18,474
15,2058 NEXTLALPAN,1,60,0,61
15,2061 NICOLAS ROMERO,87,512,0,599
15,2064 NOPALTEPEC,0,1,2,3
15,2067 OCOYOACAC,0,89159,138,89297
15,2070 OCUILAN,0,36,0,36
15,2073 EL ORO,1,163,0,164
15,2076 OTUMBA,2,82,0,84
15,2082 OTZOLOTEPEC,71,265,1,337
15,2085 OZUMBA,2,187,1,190
15,2088 PAPALOTLA,1,8,0,9
15,2091 LA PAZ,1,1,0,2
15,2094 POLOTITLAN,2,0,0,2
15,2097 RAYON,0,30,0,30
15,2100 SAN ANTONIO LA ISLA,0,23,18,41
15,2103 SAN FELIPE DEL PROGRESO,13,226,2,241
15,2106 SAN MARTIN DE LAS PIRAMIDES,3,4137,0,4140
15,2109 SAN MATEO ATENCO,0,459,0,459
15,2115 SANTO TOMAS,0,2,0,2
15,2118 SOYANIQUILPAN DE JUAREZ,17,0,0,17
15,2127 TECAMAC,17,651,1,669
15,2130 TEJUPILCO,1133,2094,1,3228
15,2133 TEMAMATLA,0,176,0,176
15,2136 TEMASCALAPA,18,193,0,211
15,2139 TEMASCALCINGO,9,586,0,595
15,2142 TEMASCALTEPEC,217,124,0,341
15,2145 TEMOAYA,293,419,2,714
15,2148 TENANCINGO,284,2007,1,2292
15,2151 TENANGO DEL AIRE,0,127,24,151
15,2154 TENANGO DEL VALLE,4,89,0,93
15,2157 TEOLOYUCAN,4,6,1,11
15,2160 TEOTIHUACAN,0,278,0,278
15,2163 TEPETLAOXTOC,51,78,2,131
15,2166 TEPETLIXPA,40,107,0,147
15,2169 TEPOTZOTLAN,7,3,0,10
15,2172 TEQUIXQUIAC,367,1,0,368
15,2175 TEXCALTITLAN,2,1,0,3
15,2178 TEXCALYACAC,0,3,0,3
15,2181 TEXCOCO,3466,8324,18,11808
15,2184 TEZOYUCA,1,374,0,375
15,2187 TIANGUISTENCO,1,509,10,520
15,2190 TIMILPAN,3,6,0,9
15,2193 TLALMANALCO,2,349,0,351
15,2196 TLALNEPANTLA DE BAZ,0,456,47,503
15,2197 TLATLAYA,0,0,1,1
15,2199 TOLUCA,3577,4014,125,7716
15,2202 TONATICO,1,15,4,20
15,2205 TULTEPEC,10,4,0,14
15,2208 TULTITLAN,48,24,89,161
15,2211 VALLE DE BRAVO,0,5,5,10
15,2214 VILLA DE ALLENDE,1,0,0,1
15,2217 VILLA DEL CARBON,1,36,0,37
15,2220 VILLA GUERRERO,6,145,4,155
15,2223 VILLA VICTORIA,74,4,1,79
15,2226 XONACATLAN,0,1022,0,1022
15,2232 ZACUALPAN,0,1,0,1
15,2235 ATIZAPAN DE ZARAGOZA,5,452,0,457
15,2238 ZINACANTEPEC,2,146874,0,146876
15,2241 ZUMPAHUACAN,4,39,3,46
15,2244 ZUMPANGO,9,507,2,518
15,7177 LUVIANOS,2,128,0,130
15,7179 VALLE DE CHALCO SOLIDARIDAD,30,19,0,49
15,7180 TONANITLA,0,54,0,54
15,7181 SAN JOSE DEL RINCON,12,26,2,40
16,2247 ACUITZIO,177,45,0,222
16,2250 AGUILILLA,5,2,0,7
16,2253 ALVARO OBREGON,370,0,11,381
16,2256 ANGAMACUTIRO,144,0,0,144
16,2259 ANGANGUEO,1,0,0,1
16,2262 APATZINGAN,1176,23,31,1230
16,2265 APORO,0,0,0,0
16,2268 AQUILA,13,0,0,13
16,2271 ARIO,204,9,8,221
16,2274 ARTEAGA,0,1,0,1
16,2277 BRISEÑAS,91,1129,79,1299
16,2280 BUENAVISTA,1165,20,4,1189
16,2283 CARACUARO,92,0,0,92
16,2286 CHARAPAN,759,0,0,759
16,2289 CHARO,7,45,0,52
16,2292 CHAVINDA,50,3655,1,3706
16,2295 CHERAN,72,2,2,76
16,2298 CHILCHOTA,0,1961,0,1961
16,2301 CHINICUILA,2,0,0,2
16,2307 CHURINTZIO,0,3,2,5
16,2313 COAHUAYANA,226,342,0,568
16,2316 COALCOMAN DE VAZQUEZ PALLARES,1090,1,0,1091
16,2319 COENEO,97,0,1,98
16,2322 CONTEPEC,318,3,1,322
16,2328 COTIJA,0,3639,1,3640
16,2331 CUITZEO,242,0,0,242
16,2334 ECUANDUREO,122,2732,6,2860
16,2336 EPITACIO HUERTA,0,14,1,15
16,2337 ERONGARICUARO,0,2,7,9
16,2340 GABRIEL ZAMORA,379,33,1,413
16,2343 HIDALGO,1,95,5,101
16,2346 LA HUACANA,514,1,0,515
16,2355 HUETAMO,135,0,1,136
16,2358 HUIRAMBA,0,3,0,3
16,2361 INDAPARAPEO,252,0,0,252
16,2364 IRIMBO,1,0,0,1
16,2367 IXTLAN,83,3890,0,3973
16,2370 JACONA,292,212,181,685
16,2373 JIMENEZ,0,0,12,12
16,2376 JIQUILPAN,420,2571,0,2991
16,2377 JOSE SIXTO VERDUZCO,1690,38,32,1760
16,2379 JUNGAPEO,534,0,0,534
16,2382 JUAREZ,69,0,0,69
16,2388 MADERO,0,46,0,46
16,2391 MARAVATIO,328,1895,0,2223
16,2392 MARCOS CASTELLANOS,0,388,0,388
16,2394 LAZARO CARDENAS,61,1685,3,1749
16,2397 MORELIA,1267,11534,166,12967
16,2403 NAHUATZEN,1237,3,0,1240
16,2406 NOCUPETARO,25,1,0,26
16,2409 NUEVO PARANGARICUTIRO,208,119,2,329
16,2412 NUEVO URECHO,12,9,0,21
16,2415 NUMARAN,1125,86,8,1219
16,2418 OCAMPO,135,1,0,136
16,2421 PAJACUARAN,0,68,4,72
16,2424 PANINDICUARO,0,0,1,1
16,2427 PARACHO,518,0,0,518
16,2430 PARACUARO,272,3,1,276
16,2433 PATZCUARO,740,1625,0,2365
16,2436 PENJAMILLO,91,5,0,96
16,2439 PERIBAN,0,512,41,553
16,2442 LA PIEDAD,694,109,215,1018
16,2445 PUREPERO,88,1740,3,1831
16,2448 PURUANDIRO,1220,137,279,1636
16,2451 QUERENDARO,1790,425,1,2216
16,2454 QUIROGA,145,368,0,513
16,2460 LOS REYES,280,1549,39,1868
16,2463 SAHUAYO,35,0,13,48
16,2466 SAN LUCAS,99,0,0,99
16,2469 SANTA ANA MAYA,159,28,29,216
16,2472 SALVADOR ESCALANTE,3,4,6,13
16,2478 SUSUPUATO,39,0,0,39
16,2481 TACAMBARO,7480,7428,19,14927
16,2484 TANCITARO,140,58,57,255
16,2487 TANGAMANDAPIO,8,2571,0,2579
16,2490 TANGANCICUARO,170,3171,2,3343
16,2493 TANHUATO,451,978,17,1446
16,2496 TARETAN,0,21,0,21
16,2499 TARIMBARO,288,44,0,332
16,2502 TEPALCATEPEC,1366,1,2,1369
16,2505 TINGAMBATO,1563,451,0,2014
16,2508 TINGüINDIN,969,0,0,969
16,2511 TIQUICHEO DE NICOLAS ROMERO,141,0,0,141
16,2514 TLALPUJAHUA,130,10,0,140
16,2517 TLAZAZALCA,1091,0,0,1091
16,2523 TUMBISCATIO,148,2,0,150
16,2526 TURICATO,0,1,0,1
16,2529 TUXPAN,0,62,1,63
16,2532 TUZANTLA,98,0,0,98
16,2535 TZINTZUNTZAN,0,0,0,0
16,2541 URUAPAN,371,3006,267,3644
16,2544 VENUSTIANO CARRANZA,1516,1233,13,2762
16,2547 VILLAMAR,110,1870,0,1980
16,2550 VISTA HERMOSA,529,21,5,555
16,2553 YURECUARO,254,380,13,647
16,2556 ZACAPU,340,37,0,377
16,2559 ZAMORA,2277,8471,724,11472
16,2562 MUGICA,53,5,2,60
16,2565 ZINAPARO,96,6,0,102
16,2568 ZINAPECUARO,583,855,24,1462
16,2574 ZITACUARO,1797,1605,5,3407
17,2577 AMACUZAC,135,413,1,549
17,2580 ATLATLAHUCAN,117,400,0,517
17,2583 AXOCHIAPAN,276,409,0,685
17,2586 AYALA,1932,3491,0,5423
17,2589 COATLAN DEL RIO,1474,2891,0,4365
17,2592 CUAUTLA,3384,4136,23,7543
17,2595 CUERNAVACA,2075,4199,3,6277
17,2598 EMILIANO ZAPATA,306,52,2,360
17,2601 HUITZILAC,297,32,0,329
17,2604 JANTETELCO,223,250,0,473
17,2607 JIUTEPEC,1368,29,4,1401
17,2610 JOJUTLA,576,1227,2,1805
17,2613 JONACATEPEC,263,221,0,484
17,2616 MAZATEPEC,903,478,1,1382
17,2619 MIACATLAN,1873,48,0,1921
17,2622 OCUITUCO,267,72,0,339
17,2625 PUENTE DE IXTLA,948,263,0,1211
17,2628 TEMIXCO,1244,48,2,1294
17,2629 TEMOAC,215,60,0,275
17,2631 TEPALCINGO,1209,65,0,1274
17,2634 TEPOZTLAN,638,271,0,909
17,2637 TETECALA,241,43,0,284
17,2640 TETELA DEL VOLCAN,154,6,0,160
17,2643 TLALNEPANTLA,7,1,0,8
17,2646 TLALTIZAPAN,6448,311,56,6815
17,2649 TLAQUILTENANGO,569,254,0,823
17,2652 TLAYACAPAN,161,265,0,426
17,2655 TOTOLAPAN,373,94,0,467
17,2658 XOCHITEPEC,81,181,0,262
17,2661 YAUTEPEC,1885,1428,0,3313
17,2664 YECAPIXTLA,682,94,0,776
17,2667 ZACATEPEC,5028,637,25,5690
17,2670 ZACUALPAN,574,279,0,853
18,2673 ACAPONETA,679,81,115,875
18,2676 AHUACATLAN,996,37,8,1041
18,2679 AMATLAN DE CAÑAS,1167,500,44,1711
18,2682 COMPOSTELA,4018,1953,10,5981
18,2688 IXTLAN DEL RIO,163,40,1,204
18,2691 JALA,731,0,0,731
18,2694 XALISCO,532,285,2,819
18,2697 DEL NAYAR,76,0,0,76
18,2700 ROSAMORADA,751,61,8,820
18,2703 RUIZ,1389,329,0,1718
18,2706 SAN BLAS,2108,128,1,2237
18,2709 SAN PEDRO LAGUNILLAS,66,0,0,66
18,2712 SANTA MARIA DEL ORO,3084,1,0,3085
18,2715 SANTIAGO IXCUINTLA,2908,864,81,3853
18,2718 TECUALA,1980,23,28,2031
18,2721 TEPIC,5413,967,447,6827
18,2724 TUXPAN,1300,336,17,1653
19,2733 AGUALEGUAS,0,0,1,1
19,2739 ALLENDE,8,63,19,90
19,2742 ANAHUAC,148,93,23,264
19,2745 APODACA,0,8,0,8
19,2748 ARAMBERRI,167,0,0,167
19,2751 BUSTAMANTE,0,500,1,501
19,2754 CADEREYTA JIMENEZ,38,3049,75,3162
19,2760 CERRALVO,0,0,2,2
19,2763 CHINA,10,2,15,27
19,2766 CIENEGA DE FLORES,0,3049,0,3049
19,2772 DR. ARROYO,547,92,0,639
19,2775 DR. COSS,0,2,0,2
19,2778 DR. GONZALEZ,0,0,18,18
19,2784 GARCIA,0,0,2,2
19,2787 SAN PEDRO GARZA GARCIA,0,0,3,3
19,2790 GRAL. BRAVO,0,2,8,10
19,2793 GRAL. ESCOBEDO,0,3049,9,3058
19,2796 GRAL. TERAN,0,50,42,92
19,2805 GRAL. ZUAZUA,0,29,1,30
19,2808 GUADALUPE,0,3053,61,3114
19,2817 HIGUERAS,0,0,16,16
19,2832 LINARES,0,14,66,80
19,2835 MARIN,0,0,4,4
19,2844 MINA,0,0,1,1
19,2847 MONTEMORELOS,0,3805,89,3894
19,2850 MONTERREY,0,3049,66,3115
19,2853 PARAS,0,0,5,5
19,2856 PESQUERIA,0,0,2,2
19,2865 SABINAS HIDALGO,0,0,36,36
19,2871 SAN NICOLAS DE LOS GARZA,0,0,66,66
19,2874 SANTA CATARINA,0,3049,15,3064
19,2877 SANTIAGO,26,696,0,722
19,2880 VALLECILLO,1,4,0,5
19,5892 GUERRERO,0,0,9,9
19,5928 NUEVO LAREDO,0,0,2,2
20,2889 ACATLAN DE PEREZ FIGUEROA,2423,1188,84,3695
20,2901 ASUNCION IXTALTEPEC,0,1,0,1
20,2904 ASUNCION NOCHIXTLAN,0,25,6,31
20,2907 ASUNCION OCOTLAN,0,0,2,2
20,2913 AYOTZINTEPEC,1940,2,1,1943
20,2928 CANDELARIA LOXICHA,96,211,0,307
20,2931 CHAHUITES,175,108,19,302
20,2943 CIENEGA DE ZIMATLAN,0,9,0,9
20,2946 CIUDAD IXTEPEC,144,348,3,495
20,2952 COICOYAN DE LAS FLORES,263,0,0,263
20,2979 VILLA DIAZ ORDAZ,0,5,0,5
20,2982 HEROICA CIUDAD DE EJUTLA DE CRESPO,626,56,0,682
20,2985 EL ESPINAL,0,9,0,9
20,2994 GUADALUPE ETLA,19,27,0,46
20,2997 GUADALUPE DE RAMIREZ,0,1,0,1
20,3000 GUELATAO DE JUAREZ,6,0,0,6
20,3009 VILLA HIDALGO,25,0,8,33
20,3012 HEROICA CIUDAD DE HUAJUAPAN DE LEON,9848,6205,0,16053
20,3013 HUAUTEPEC,0,2,0,2
20,3015 HUAUTLA DE JIMENEZ,0,23,0,23
20,3021 IXTLAN DE JUAREZ,4,0,0,4
20,3027 HEROICA CIUDAD DE JUCHITAN DE ZARAGOZA,498,1744,2,2244
20,3030 LOMA BONITA,998,273,2,1273
20,3033 MAGDALENA APASCO,18,3,0,21
20,3054 MAGDALENA TEQUISISTLAN,0,2,0,2
20,3066 MARTIRES DE TACUBAYA,1,0,0,1
20,3069 MATIAS ROMERO AVENDAÑO,1753,2070,0,3823
20,3072 MAZATLAN VILLA DE FLORES,0,8,0,8
20,3075 MIAHUATLAN DE PORFIRIO DIAZ,283,52,1,336
20,3084 NAZARENO ETLA,109,19,0,128
20,3096 SANTIAGO NILTEPEC,82,22,5,109
20,3099 OAXACA DE JUAREZ,4518,5435,59,10012
20,3102 OCOTLAN DE MORELOS,188,174,0,362
20,3108 PINOTEPA DE DON LUIS,226,4,0,230
20,3111 PLUMA HIDALGO,0,9,0,9
20,3117 PUTLA VILLA DE GUERRERO,973,69,0,1042
20,3126 REFORMA DE PINEDA,40,21,0,61
20,3129 LA REFORMA,159,0,0,159
20,3132 REYES ETLA,30,1,1,32
20,3141 SALINA CRUZ,0,1689,0,1689
20,3156 SAN AGUSTIN DE LAS JUNTAS,0,1,2,3
20,3159 SAN AGUSTIN ETLA,332,30,0,362
20,3162 SAN AGUSTIN LOXICHA,234,43,0,277
20,3165 SAN AGUSTIN TLACOTEPEC,0,0,2,2
20,3168 SAN AGUSTIN YATARENI,0,3,1,4
20,3177 SAN ANDRES HUAXPALTEPEC,27,3,0,30
20,3183 SAN ANDRES IXTLAHUACA,24,0,0,24
20,3195 SAN ANDRES SINAXTLA,0,0,1,1
20,3201 SAN ANDRES TEOTILALPAM,1,1,0,2
20,3213 SAN ANDRES ZAUTLA,57,10,0,67
20,3222 SAN ANTONINO MONTE VERDE,449,0,0,449
20,3237 SAN ANTONIO NANAHUATIPAM,0,10,0,10
20,3243 SAN ANTONIO TEPETLAPA,169,0,0,169
20,3246 SAN BALTAZAR CHICHICAPAM,0,9,0,9
20,3255 SAN BARTOLO COYOTEPEC,0,0,1,1
20,3264 SAN BARTOLOME AYAUTLA,0,2,0,2
20,3267 SAN BARTOLOME LOXICHA,0,12,0,12
20,3273 SAN BARTOLOME YUCUAÑE,1,0,0,1
20,3282 SAN BLAS ATEMPA,0,15,0,15
20,3303 SAN DIONISIO DEL MAR,0,7,0,7
20,3306 SAN DIONISIO OCOTEPEC,203,0,0,203
20,3315 SAN FELIPE JALAPA DE DIAZ,0,59,0,59
20,3318 SAN FELIPE TEJALAPAM,9,0,0,9
20,3336 SAN FRANCISCO DEL MAR,392,4,0,396
20,3342 SAN FRANCISCO IXHUATAN,78,0,2,80
20,3348 SAN FRANCISCO LACHIGOLO,24,45,0,69
20,3357 SAN FRANCISCO OZOLOTEPEC,196,0,0,196
20,3363 SAN FRANCISCO TELIXTLAHUACA,144,155,0,299
20,3372 SAN GABRIEL MIXTEPEC,409,427,0,836
20,3384 SAN JACINTO AMILPAS,3,0,0,3
20,3411 SAN JOSE CHILTEPEC,0,2,0,2
20,3417 SAN JOSE ESTANCIA GRANDE,1,10,1,12
20,3426 SAN JOSE TENANGO,1734,0,0,1734
20,3429 SAN JUAN ACHIUTLA,0,1,0,1
20,3444 SAN JUAN BAUTISTA CUICATLAN,0,70,0,70
20,3447 SAN JUAN BAUTISTA GUELACHE,0,17,0,17
20,3450 SAN JUAN BAUTISTA JAYACATLAN,0,1,0,1
20,3453 SAN JUAN BAUTISTA LO DE SOTO,0,3,0,3
20,3465 SAN JUAN BAUTISTA TUXTEPEC,3667,5952,76,9695
20,3471 SAN JUAN CACAHUATEPEC,1090,205,2,1297
20,3486 SAN JUAN COLORADO,0,13,0,13
20,3492 SAN JUAN COTZOCON,1269,3,8,1280
20,3495 SAN JUAN DEL ESTADO,12,1,0,13
20,3510 SAN JUAN GUICHICOVI,323,10,0,333
20,3531 SAN JUAN LALANA,289,0,0,289
20,3534 SAN JUAN DE LOS CUES,0,2,0,2
20,3537 SAN JUAN MAZATLAN,280,11,0,291
20,3540 SAN JUAN MIXTEPEC -DTO. 08 -,0,1,0,1
20,3591 SAN LORENZO,0,10,0,10
20,3597 SAN LORENZO CACAOTEPEC,227,64,0,291
20,3612 SAN LUCAS OJITLAN,572,0,0,572
20,3627 SAN MARCOS ARTEAGA,1,1,0,2
20,3633 SAN MARTIN HUAMELULPAM,0,1,0,1
20,3642 SAN MARTIN PERAS,303,0,0,303
20,3648 SAN MARTIN TOXPALAN,0,2,0,2
20,3663 SAN MATEO YOLOXOCHITLAN,0,3,0,3
20,3687 SAN MELCHOR BETAZA,0,4,0,4
20,3699 SAN MIGUEL AMATITLAN,0,0,1,1
20,3708 SAN MIGUEL CHIMALAPA,648,0,0,648
20,3714 SAN MIGUEL DEL PUERTO,0,1679,0,1679
20,3726 SAN MIGUEL HUAUTLA,0,49,0,49
20,3738 SAN MIGUEL PERAS,89,0,0,89
20,3744 SAN MIGUEL QUETZALTEPEC,563,0,0,563
20,3753 SAN MIGUEL SOYALTEPEC,138,1,1,140
20,3754 SAN MIGUEL SUCHIXTEPEC,179,63,0,242
20,3774 SAN MIGUEL TLACAMAMA,0,11,0,11
20,3801 SAN PABLO ETLA,52,14,3,69
20,3804 SAN PABLO HUITZO,45,17,0,62
20,3807 SAN PABLO HUIXTEPEC,549,55,5,609
20,3814 SAN PABLO VILLA DE MITLA,0,9,0,9
20,3823 SAN PEDRO APOSTOL,33,0,0,33
20,3840 SAN PEDRO HUAMELULA,869,0,0,869
20,3843 SAN PEDRO HUILOTEPEC,0,5,0,5
20,3855 SAN PEDRO JICAYAN,0,10,0,10
20,3861 SAN PEDRO JUCHATENGO,0,19,0,19
20,3873 SAN PEDRO MIXTEPEC -DTO. 22 -,536,343,6,885
20,3876 SAN PEDRO MOLINOS,56,0,0,56
20,3885 SAN PEDRO OCOTEPEC,175,0,0,175
20,3888 SAN PEDRO POCHUTLA,578,1375,0,1953
20,3895 SAN PEDRO TAPANATEPEC,329,184,23,536
20,3912 SAN PEDRO TOTOLAPA,66,21,0,87
20,3915 VILLA DE TUTUTEPEC DE MELCHOR OCAMPO,330,172,23,525
20,3918 SAN PEDRO Y SAN PABLO AYUTLA,282,0,0,282
20,3921 VILLA DE ETLA,513,0,0,513
20,3924 SAN PEDRO Y SAN PABLO TEPOSCOLULA,2,1,0,3
20,3948 SAN SEBASTIAN IXCAPA,253,43,0,296
20,3954 SAN SEBASTIAN RIO HONDO,37,0,0,37
20,3957 SAN SEBASTIAN TECOMAXTLAHUACA,292,0,0,292
20,3963 SAN SEBASTIAN TUTLA,0,0,4,4
20,3966 SAN SIMON ALMOLONGAS,239,0,0,239
20,4014 SANTA CATARINA JUQUILA,0,1,0,1
20,4023 SANTA CATARINA MECHOACAN,0,1,0,1
20,4038 SANTA CATARINA YOSONOTU,0,2,0,2
20,4047 SANTA CRUZ AMILPAS,0,28,0,28
20,4053 SANTA CRUZ ITUNDUJIA,62,0,0,62
20,4077 SANTA CRUZ XOXOCOTLAN,135,259,0,394
20,4089 SANTA INES DEL MONTE,88,0,0,88
20,4095 SANTA LUCIA DEL CAMINO,7,48,6,61
20,4125 SANTA MARIA LA ASUNCION,60,47,0,107
20,4128 HEROICA CIUDAD DE TLAXIACO,478,421,0,899
20,4131 AYOQUEZCO DE ALDAMA,690,9,0,699
20,4134 SANTA MARIA ATZOMPA,22,8,0,30
20,4137 SANTA MARIA CAMOTLAN,0,8,0,8
20,4140 SANTA MARIA CHACHOAPAM,0,1,0,1
20,4146 SANTA MARIA CHILCHOTLA,882,14,0,896
20,4152 SANTA MARIA COLOTEPEC,512,68,2,582
20,4155 SANTA MARIA CORTIJO,5,19,3,27
20,4158 SANTA MARIA COYOTEPEC,0,33,0,33
20,4173 SANTA MARIA GUIENAGATI,1138,0,0,1138
20,4176 SANTA MARIA HUATULCO,497,2614,0,3111
20,4179 SANTA MARIA HUAZOLOTITLAN,191,55,0,246
20,4182 SANTA MARIA IPALAPA,1,0,0,1
20,4188 SANTA MARIA JACATEPEC,2409,1,1,2411
20,4191 SANTA MARIA JALAPA DEL MARQUES,0,36,0,36
20,4203 SANTA MARIA MIXTEQUILLA,405,0,0,405
20,4212 SANTA MARIA OZOLOTEPEC,156,0,0,156
20,4221 SANTA MARIA PETAPA,0,13,0,13
20,4224 SANTA MARIA SOLA,93,55,0,148
20,4233 SANTA MARIA TEMAXCALTEPEC,444,0,0,444
20,4251 SANTA MARIA TONAMECA,8,80,6,94
20,4254 SANTA MARIA TOTOLAPILLA,465,0,0,465
20,4257 SANTA MARIA XADANI,0,51,0,51
20,4272 SANTA MARIA ZACATEPEC,816,8,0,824
20,4299 SANTIAGO ATITLAN,85,0,0,85
20,4314 SANTIAGO CHOAPAM,0,1,0,1
20,4338 SANTIAGO JAMILTEPEC,459,23,1,483
20,4344 SANTIAGO JUXTLAHUACA,315,169,0,484
20,4353 SANTIAGO LAOLLAGA,0,3,0,3
20,4359 SANTIAGO LLANO GRANDE,0,10,0,10
20,4362 SANTIAGO MATATLAN,26,6,0,32
20,4371 SANTIAGO MINAS,0,2,0,2
20,4386 SANTIAGO PINOTEPA NACIONAL,318,1983,6,2307
20,4389 SANTIAGO SUCHILQUITONGO,104,377,0,481
20,4395 SANTIAGO TAPEXTLA,0,3,0,3
20,4416 SANTIAGO TEXTITLAN,106,5,0,111
20,4428 SANTIAGO XANICA,37,0,0,37
20,4437 SANTIAGO YAVEO,0,2,0,2
20,4455 NUEVO ZOQUIAPAM,121,8,0,129
20,4458 SANTO DOMINGO INGENIO,0,153,0,153
20,4464 SANTO DOMINGO ARMENTA,0,17,0,17
20,4473 SANTO DOMINGO IXCATLAN,1,0,0,1
20,4482 SANTO DOMINGO PETAPA,0,18,0,18
20,4488 SANTO DOMINGO TEHUANTEPEC,2275,2005,2,4282
20,4503 SANTO DOMINGO TONALA,0,2,0,2
20,4512 SANTO DOMINGO YANHUITLAN,0,1,0,1
20,4518 SANTO DOMINGO ZANATEPEC,192,15,8,215
20,4521 SANTO TOMAS MAZALTEPEC,23,6,0,29
20,4530 SANTOS REYES NOPALA,516,0,0,516
20,4545 SILACAYOAPAM,0,181,0,181
20,4551 SOLEDAD ETLA,173,1713,0,1886
20,4554 VILLA DE TAMAZULAPAM DEL PROGRESO,173,174,0,347
20,4563 TATALTEPEC DE VALDES,1668,0,0,1668
20,4572 TEOTITLAN DEL VALLE,0,80,0,80
20,4578 TEZOATLAN DE SEGURA Y LUNA,0,8,0,8
20,4584 TLACOLULA DE MATAMOROS,176,133,0,309
20,4590 TLALIXTAC DE CABRERA,0,1,2,3
20,4608 UNION HIDALGO,16,265,10,291
20,4611 VALERIO TRUJANO,0,16,0,16
20,4626 VILLA DE ZAACHILA,548,87,0,635
20,4641 ZIMATLAN DE ALVAREZ,14822,59,0,14881
21,4644 ACAJETE,225,176,0,401
21,4647 ACATENO,17,36,2,55
21,4650 ACATLAN,0,1589,0,1589
21,4653 ACATZINGO,76,353,8,437
21,4656 ACTEOPAN,14,6,0,20
21,4662 AHUATLAN,34,0,0,34
21,4665 AHUAZOTEPEC,7,21,0,28
21,4671 AJALPAN,185,135,3,323
21,4677 ALJOJUCA,480,4,0,484
21,4680 ALTEPEXI,244,137,0,381
21,4683 AMIXTLAN,0,3,0,3
21,4686 AMOZOC,93,176,0,269
21,4689 AQUIXTLA,8,41,9,58
21,4695 ATEXCAL,0,0,3,3
21,4698 ATLIXCO,34,1620,2,1656
21,4701 ATOYATEMPAN,28,15,0,43
21,4707 ATZITZINTLA,197,0,0,197
21,4710 ATZITZIHUACAN,57,1,0,58
21,4716 AYOTOXCO DE GUERRERO,0,2,0,2
21,4719 CALPAN,0,19,0,19
21,4728 CAXHUACAN,0,1,0,1
21,4731 CHALCHICOMULA DE SESMA,574,14,1,589
21,4734 CHAPULCO,16,6,0,22
21,4737 CHIAUTLA,23,12,0,35
21,4740 CHIAUTZINGO,67,38,2,107
21,4743 CHICHIQUILA,0,4,0,4
21,4749 CHIETLA,3230,484,45,3759
21,4752 CHIGMECATITLAN,5,0,0,5
21,4755 CHIGNAHUAPAN,793,431,0,1224
21,4758 CHIGNAUTLA,22,1,0,23
21,4761 CHILA,8,0,0,8
21,4764 CHILA DE LA SAL,1,0,0,1
21,4779 COATZINGO,35,0,0,35
21,4785 COHUECAN,50,0,0,50
21,4788 CORONANGO,2,42,0,44
21,4791 COXCATLAN,53,156,0,209
21,4794 COYOMEAPAN,31,2,0,33
21,4800 CUAUTEMPAN,125,12,0,137
21,4803 CUAUTINCHAN,10,19,0,29
21,4806 CUAUTLANCINGO,5,146,0,151
21,4809 CUAYUCA DE ANDRADE,30,0,0,30
21,4812 CUETZALAN DEL PROGRESO,2925,0,0,2925
21,4815 CUAPIAXTLA DE MADERO,0,5,2,7
21,4818 CUYOACO,3246,43,2,3291
21,4821 DOMINGO ARENAS,0,40,0,40
21,4827 EPATLAN,0,2,0,2
21,4830 ESPERANZA,128,3,0,131
21,4836 GENERAL FELIPE ANGELES,1,23,0,24
21,4842 GUADALUPE VICTORIA,23,15,7,45
21,4848 HUAQUECHULA,58,32,0,90
21,4851 HUATLATLAUCA,21,0,0,21
21,4854 HUAUCHINANGO,25,1591,0,1616
21,4860 HUEHUETLAN EL CHICO,64,9,0,73
21,4863 HUEJOTZINGO,9,1612,3,1624
21,4866 HUEYAPAN,20,0,0,20
21,4869 HUEYTAMALCO,339,46,2,387
21,4875 HUITZILAN DE SERDAN,1229,1589,0,2818
21,4878 HUITZILTEPEC,78,128,1,207
21,4884 IXCAMILPA DE GUERRERO,3,0,0,3
21,4887 IXCAQUIXTLA,14,40,0,54
21,4890 IXTACAMAXTITLAN,105,2,0,107
21,4893 IXTEPEC,227,0,0,227
21,4896 IZUCAR DE MATAMOROS,99,90,0,189
21,4899 JALPAN,0,6,0,6
21,4902 JOLALPAN,37,1,0,38
21,4908 JOPALA,8,0,2,10
21,4911 JUAN C. BONILLA,17,9,0,26
21,4914 JUAN GALINDO,10,0,0,10
21,4920 LAFRAGUA,0,0,2,2
21,4923 LIBRES,631,8,4,643
21,4929 MAZAPILTEPEC DE JUAREZ,44,0,0,44
21,4935 MOLCAXAC,24,0,0,24
21,4938 CAÑADA MORELOS,139,0,1,140
21,4941 NAUPAN,0,2,0,2
21,4950 NICOLAS BRAVO,8,26,3,37
21,4953 NOPALUCAN,558,0,0,558
21,4956 OCOTEPEC,41,2,0,43
21,4959 OCOYUCAN,3,40,0,43
21,4962 OLINTLA,248,0,0,248
21,4965 ORIENTAL,92,3,0,95
21,4968 PAHUATLAN,21,14,0,35
21,4971 PALMAR DE BRAVO,4,0,0,4
21,4974 PANTEPEC,1,1,1,3
21,4980 PIAXTLA,22,0,0,22
21,4983 PUEBLA,927,11034,189,12150
21,4986 QUECHOLAC,226,198,2,426
21,4992 RAFAEL LARA GRAJALES,328,1661,0,1989
21,4998 LOS REYES DE JUAREZ,11,49,0,60
21,5001 SAN ANDRES CHOLULA,195,1692,39,1926
21,5004 SAN ANTONIO CAÑADA,0,11,0,11
21,5013 SAN FELIPE TEOTLALCINGO,0,18,0,18
21,5019 SAN GABRIEL CHILAC,281,29,0,310
21,5022 SAN GREGORIO ATZOMPA,2,3,0,5
21,5034 SAN JOSE CHIAPA,154,1,0,155
21,5037 SAN JOSE MIAHUATLAN,116,90,2,208
21,5040 SAN JUAN ATENCO,121,6,0,127
21,5046 SAN MARTIN TEXMELUCAN,64,283,6,353
21,5054 SAN MATIAS TLALANCALECA,115,40,0,155
21,5061 SAN MIGUEL XOXTLA,0,17,0,17
21,5064 SAN NICOLAS BUENOS AIRES,27,6,0,33
21,5067 SAN NICOLAS DE LOS RANCHOS,0,4,0,4
21,5073 SAN PEDRO CHOLULA,0,9,9,18
21,5079 SAN SALVADOR EL SECO,214,263,130,607
21,5082 SAN SALVADOR EL VERDE,27,38,3,68
21,5085 SAN SALVADOR HUIXCOLOTLA,71,104,0,175
21,5088 SAN SEBASTIAN TLACOTEPEC,19,0,0,19
21,5091 SANTA CATARINA TLALTEMPAN,11,0,0,11
21,5094 SANTA INES AHUATEMPAN,61,0,0,61
21,5097 SANTA ISABEL CHOLULA,2,18,0,20
21,5100 SANTIAGO MIAHUATLAN,39,27,0,66
21,5109 SOLTEPEC,295,3,0,298
21,5112 TECALI DE HERRERA,54,304,0,358
21,5115 TECAMACHALCO,981,2020,15,3016
21,5118 TECOMATLAN,20,1,0,21
21,5121 TEHUACAN,574,5960,17,6551
21,5124 TEHUITZINGO,22,0,0,22
21,5127 TENAMPULCO,0,0,1,1
21,5130 TEOPANTLAN,4,0,0,4
21,5133 TEOTLALCO,0,2,0,2
21,5136 TEPANCO DE LOPEZ,263,87,32,382
21,5139 TEPANGO DE RODRIGUEZ,0,6,0,6
21,5142 TEPATLAXCO DE HIDALGO,147,36,0,183
21,5145 TEPEACA,461,1500,0,1961
21,5151 TEPEOJUMA,5,0,0,5
21,5154 TEPETZINTLA,0,405,0,405
21,5157 TEPEXCO,54,30,0,84
21,5160 TEPEXI DE RODRIGUEZ,229,1,0,230
21,5163 TEPEYAHUALCO,289,31,1,321
21,5166 TEPEYAHUALCO DE CUAUHTEMOC,11,0,0,11
21,5169 TETELA DE OCAMPO,117,58,0,175
21,5172 TETELES DE AVILA CASTILLO,5,0,0,5
21,5175 TEZIUTLAN,313,1650,1,1964
21,5178 TIANGUISMANALCO,1,0,0,1
21,5181 TILAPA,18,28,0,46
21,5184 TLACHICHUCA,1055,25,0,1080
21,5187 TLACOTEPEC DE BENITO JUAREZ,273,41,9,323
21,5190 TLACUILOTEPEC,0,3,0,3
21,5193 TLAHUAPAN,1704,262,4,1970
21,5196 TLANEPANTLA,35,57,0,92
21,5202 TLAOLA,20,0,0,20
21,5205 TLAPACOYA,1,0,0,1
21,5208 TLAPANALA,22,16,0,38
21,5211 TLATLAUQUITEPEC,40,8,0,48
21,5214 TLAXCO,0,61,0,61
21,5217 TOCHIMILCO,2,43,0,45
21,5220 TOCHTEPEC,113,16,0,129
21,5229 TULCINGO,73,0,1,74
21,5235 TZICATLACOYAN,38,0,0,38
21,5238 VENUSTIANO CARRANZA,0,44,3,47
21,5241 VICENTE GUERRERO,0,9,0,9
21,5248 XICOTEPEC,1111,631,78,1820
21,5250 XICOTLAN,22,0,0,22
21,5253 XIUTETELCO,15,0,0,15
21,5259 XOCHILTEPEC,3,3,1,7
21,5262 XOCHITLÁN DE VICENTE SUÁREZ,8,0,0,8
21,5265 XOCHITLAN TODOS SANTOS,242,0,0,242
21,5268 YAONAHUAC,10,0,0,10
21,5271 YEHUALTEPEC,42,54,0,96
21,5274 ZACAPALA,1,0,0,1
21,5277 ZACAPOAXTLA,11,1588,0,1599
21,5280 ZACATLAN,27,1617,2,1646
21,5283 ZAPOTITLAN,30,0,0,30
21,5289 ZARAGOZA,14,5,0,19
21,5292 ZAUTLA,0,2,0,2
21,5295 ZIHUATEUTLA,284,0,26,310
21,5298 ZINACATEPEC,62,125,0,187
21,5301 ZONGOZOTLA,138,0,0,138
22,5310 AMEALCO DE BONFIL,2168,6,0,2174
22,5319 CADEREYTA DE MONTES,0,7,14,21
22,5322 COLON,0,5,44,49
22,5325 CORREGIDORA,311,1,74,386
22,5328 EZEQUIEL MONTES,39,2,98,139
22,5331 HUIMILPAN,258,3,20,281
22,5334 JALPAN DE SERRA,1484,47,1,1532
22,5340 EL MARQUES,2505,74,94,2673
22,5343 PEDRO ESCOBEDO,1660,19,38,1717
22,5349 QUERETARO,262,1978,43,2283
22,5355 SAN JUAN DEL RIO,3404,931,32,4367
22,5358 TEQUISQUIAPAN,0,0,3,3
23,5362 BENITO JUAREZ,12,3487,37,3536
23,5363 JOSE MARIA MORELOS,0,477,0,477
23,5367 FELIPE CARRILLO PUERTO,165,3512,0,3677
23,5370 ISLA MUJERES,0,0,5,5
23,5371 LAZARO CARDENAS,0,7,0,7
23,5372 OTHON P. BLANCO,19424,19635,1748,40807
23,5373 SOLIDARIDAD,0,1916,13,1929
24,5379 ALAQUINES,0,0,2,2
24,5382 AXTLA DE TERRAZAS,0,156,0,156
24,5385 AQUISMON,347,197,4,548
24,5391 CARDENAS,7,31,0,38
24,5397 CIUDAD FERNANDEZ,438,125,0,563
24,5400 CEDRAL,0,5,0,5
24,5412 CIUDAD VALLES,4972,3687,301,8960
24,5415 CIUDAD DEL MAIZ,6362,695,142,7199
24,5420 EBANO,807,415,42,1264
24,5424 GUADALCAZAR,665,22,0,687
24,"5425 VILLA DE ARISTA, S.L.P.",40,0,0,40
24,5427 VILLA DE GUADALUPE,13,36,0,49
24,5436 MATEHUALA,0,970,2,972
24,5439 MEXQUITIC DE CARMONA,4,0,1,5
24,5442 MOCTEZUMA,1,0,0,1
24,5448 SAN CIRO DE ACOSTA,17,0,0,17
24,5451 VILLA DE RAMOS,687,23,18,728
24,5454 RAYON,0,21,3,24
24,5457 RIOVERDE,174,3651,36,3861
24,5463 SALINAS,63,9,0,72
24,5469 SAN LUIS POTOSI,17,6033,106,6156
24,5472 SAN MARTIN CHALCHICUAUTLA,5,3,2,10
24,5475 SANTA CATARINA,1,0,0,1
24,5481 SANTO DOMINGO,112,8,0,120
24,5484 SOLEDAD DE GRACIANO SANCHEZ,14,0,0,14
24,5487 TAMASOPO,4124,402,69,4595
24,5490 TAMAZUNCHALE,0,1127,0,1127
24,5493 TAMPACAN,3,0,0,3
24,5496 TAMPAMOLON CORONA,1,12,0,13
24,5499 TAMUIN,235,75,187,497
24,5502 SAN VICENTE TANCUAYALAB,33,14,19,66
24,5505 TANLAJAS,0,2,6,8
24,5508 TANQUIAN DE ESCOBEDO,18,21,1,40
24,5514 VENADO,0,0,1,1
24,5520 VILLA DE ARRIAGA,227,10,2,239
24,5523 VILLA HIDALGO,6,9,0,15
24,5526 VILLA DE REYES,70,19,0,89
24,5539 MATLAPA,0,4,0,4
24,5540 EL NARANJO,788,211,41,1040
25,5538 AHOME,3805,3293,2902,10000
25,5541 ANGOSTURA,1181,547,124,1852
25,5547 CHOIX,74,0,0,74
25,5550 CONCORDIA,27,11,0,38
25,5553 COSALA,3,0,0,3
25,5556 CULIACAN,16722,5958,1977,24657
25,5559 EL FUERTE,567,108,182,857
25,5562 ELOTA,151,93,36,280
25,5565 ESCUINAPA,240,19,10,269
25,5568 GUASAVE,2315,7443,861,10619
25,5571 MAZATLAN,1186,22310,179,23675
25,5574 MOCORITO,205,8,14,227
25,5575 NAVOLATO,2050,510,465,3025
25,5577 ROSARIO,1937,130,11,2078
25,5578 SALVADOR ALVARADO,338,1183,664,2185
25,5580 SAN IGNACIO,94,5,5,104
25,5583 SINALOA,554,188,117,859
26,5586 ACONCHI,34,31,2,67
26,5589 AGUA PRIETA,0,1,25,26
26,5592 ALAMOS,156,156,3,315
26,5595 ALTAR,0,0,1,1
26,5598 ARIVECHI,7,10,1,18
26,5601 ARIZPE,3,14,7,24
26,5604 ATIL,1,0,7,8
26,5607 BACADEHUACHI,13,15,6,34
26,5610 BACANORA,14,10,0,24
26,5613 BACERAC,2,1,0,3
26,5616 BACOACHI,2,3,0,5
26,5619 BACUM,45,45,33,123
26,5622 BANAMICHI,7,13,4,24
26,5628 BAVIACORA,3,32,6,41
26,5631 BAVISPE,9,4,1,14
26,5633 BENITO JUAREZ,97,152,6,255
26,5634 BENJAMIN HILL,1,3,0,4
26,5637 CABORCA,257,1725,146,2128
26,5640 CAJEME,6753,1463,2367,10583
26,5643 CANANEA,2,1,3,6
26,5646 CARBO,1,7,4,12
26,5649 LA COLORADA,12,51,0,63
26,5652 CUCURPE,0,1,8,9
26,5655 CUMPAS,4,2,9,15
26,5658 DIVISADEROS,18,10,1,29
26,5661 EMPALME,0,14,29,43
26,5664 ETCHOJOA,526,591,75,1192
26,5667 FRONTERAS,21,7,3,31
26,5670 GRANADOS,3,36,46,85
26,5673 GUAYMAS,439,2138,333,2910
26,5674 SAN IGNACIO RIO MUERTO,101,211,11,323
26,5676 HERMOSILLO,636,1008,1020,2664
26,5679 HUACHINERA,2,6,7,15
26,5682 HUASABAS,2,1,0,3
26,5685 HUATABAMPO,172,165,191,528
26,5688 HUEPAC,2,9,5,16
26,5691 IMURIS,2,3,0,5
26,5694 MAGDALENA,2,2,4,8
26,5697 MAZATAN,2,1,3,6
26,5700 MOCTEZUMA,1,13,5,19
26,5706 NACORI CHICO,31,30,6,67
26,5712 NAVOJOA,853,1386,319,2558
26,5718 ONAVAS,7,11,0,18
26,5721 OPODEPE,3,11,1,15
26,5724 VILLA HIDALGO,0,1,0,1
26,5727 OQUITOA,3,2,0,5
26,5730 PITIQUITO,9,13,0,22
26,5731 GENERAL PLUTARCO ELIAS CALLES,6,0,1,7
26,5733 PUERTO PEÑASCO,357,1870,28,2255
26,5737 QUIRIEGO,3,2,13,18
26,5739 RAYON,1,4,28,33
26,5742 ROSARIO,83,21,9,113
26,5745 SAHUARIPA,39,26,6,71
26,5751 SAN JAVIER,0,0,2,2
26,5754 SAN LUIS RIO COLORADO,783,1163,71,2017
26,5757 SAN MIGUEL DE HORCASITAS,2,6,9,17
26,5760 SAN PEDRO DE LA CUEVA,4,3,0,7
26,5763 SANTA ANA,1,10,2,13
26,5766 SANTA CRUZ,0,1,0,1
26,5769 SARIC,0,5,1,6
26,5772 SOYOPA,23,9,3,35
26,5778 SUAQUI GRANDE,2,9,0,11
26,5781 TEPACHE,3,1,0,4
26,5787 TRINCHERAS,2,3,6,11
26,5790 TUBUTAMA,1,1,1,3
26,5793 URES,21,48,8,77
26,5796 VILLA PESQUEIRA,21,27,18,66
26,5799 YECORA,61,30,6,97
27,5802 BALANCAN,172,72,148,392
27,5805 CARDENAS,1725,7294,342,9361
27,5808 CENTLA,299,467,11,777
27,5811 CENTRO,634,7625,223,8482
27,5814 COMALCALCO,7445,3447,60,10952
27,5817 CUNDUACAN,170,185,4,359
27,5820 EMILIANO ZAPATA,5260,7650,161,13071
27,5823 HUIMANGUILLO,696,687,76,1459
27,5826 JALAPA,204,28,8,240
27,5829 JALPA DE MENDEZ,48,51,2,101
27,5832 JONUTA,252,108,21,381
27,5835 MACUSPANA,197,2762,51,3010
27,5838 NACAJUCA,36,236,3,275
27,5841 PARAISO,46,2803,1,2850
27,5844 TEAPA,312,2663,24,2999
27,5847 TENOSIQUE,315,2677,19,3011
27,5850 TACOTALPA,682,10,13,705
28,5853 ABASOLO,415,89,199,703
28,5856 ALDAMA,28,320,782,1130
28,5859 ALTAMIRA,91,1954,61,2106
28,5862 ANTIGUO MORELOS,569,77,14,660
28,5865 BURGOS,104,11,3,118
28,5868 BUSTAMANTE,1,0,0,1
28,5871 CAMARGO,103,24,10,137
28,5874 CASAS,42,22,5,69
28,5880 CRUILLAS,2,5,2,9
28,5881 GUSTAVO DIAZ ORDAZ,251,80,36,367
28,5883 GOMEZ FARIAS,44,417,49,510
28,5886 GONZALEZ,120,129,345,594
28,5889 GüEMEZ,2,3,1,6
28,5895 HIDALGO,20,4,8,32
28,5898 JAUMAVE,1,0,0,1
28,5901 JIMENEZ,9,2,9,20
28,5904 LLERA,8,1,42,51
28,5910 EL MANTE,2064,2129,111,4304
28,5913 MATAMOROS,697,2258,451,3406
28,5916 MENDEZ,6992,68,35,7095
28,5919 MIER,0,0,8,8
28,5922 MIGUEL ALEMAN,4,5,2,11
28,5931 NUEVO MORELOS,819,91,2,912
28,5934 OCAMPO,2639,434,43,3116
28,5937 PADILLA,26,11,15,52
28,5943 REYNOSA,1163,2043,390,3596
28,5944 RIO BRAVO,3871,577,574,5022
28,5946 SAN CARLOS,15,1,6,22
28,5949 SAN FERNANDO,2014,406,766,3186
28,5955 SOTO LA MARINA,92,41,148,281
28,5958 TAMPICO,1,1906,45,1952
28,5961 TULA,0,0,4,4
28,5964 VALLE HERMOSO,1614,486,884,2984
28,5967 VICTORIA,33,2857,110,3000
28,5970 VILLAGRAN,1,1,2,4
28,5973 XICOTENCATL,210,153,49,412
29,5976 AMAXAC DE GUERRERO,12,10,0,22
29,5979 APETATITLAN DE ANTONIO CARVAJAL,44,0,0,44
29,5982 ATLANGATEPEC,155,10,0,165
29,5985 ALTZAYANCA,355,42,0,397
29,5988 APIZACO,151,881,0,1032
29,5991 CALPULALPAN,711,725,10,1446
29,5994 EL CARMEN TEQUEXQUITLA,0,20,0,20
29,5997 CHIAUTEMPAN,57,9,0,66
29,6000 CUAPIAXTLA,265,18,2,285
29,6003 CUAXOMULCO,2,0,1,3
29,6006 MUÑOZ DE DOMINGO ARENAS,53,2,0,55
29,6009 ESPAÑITA,41,7,0,48
29,6012 HUAMANTLA,1121,681,10,1812
29,6015 HUEYOTLIPAN,115,1,0,116
29,6018 IXTACUIXTLA DE MARIANO MATAMOROS,147,28,0,175
29,6021 IXTENCO,64,0,0,64
29,6024 MAZATECOCHCO DE JOSE MARIA MORELOS,5,0,0,5
29,6027 CONTLA DE JUAN CUAMATZI,47,15,0,62
29,6030 TEPETITLA DE LARDIZABAL,42,16,0,58
29,6033 LAZARO CARDENAS,93,17,0,110
29,6036 NANACAMILPA DE MARIANO ARISTA,163,5,0,168
29,6039 ACUAMANALA DE MIGUEL HIDALGO,10,0,0,10
29,6042 NATIVITAS,31,733,0,764
29,6045 PANOTLA,56,0,0,56
29,6048 SAN PABLO DEL MONTE,60,28,1,89
29,6051 SANTA CRUZ TLAXCALA,19,27,10,56
29,6054 TOCATLAN,27,11,0,38
29,6057 TENANCINGO,2,0,0,2
29,6060 TEOLOCHOLCO,16,0,1,17
29,6063 TEPEYANCO,20,0,0,20
29,6066 TERRENATE,57,1,0,58
29,6069 TETLA DE LA SOLIDARIDAD,42,2,0,44
29,6072 TETLATLAHUCA,61,41,3,105
29,6075 TLAXCALA,173,688,4,865
29,6078 TLAXCO,260,52,0,312
29,6081 TOTOLAC,45,0,3,48
29,6084 ZITLALTEPEC DE TRINIDAD SANCHEZ SANTOS,6,0,0,6
29,6087 TZOMPANTEPEC,69,12,0,81
29,6090 XALOZTOC,65,38,0,103
29,6093 XALTOCAN,27,29,0,56
29,6096 XICOHTZINCO,3,0,0,3
29,6099 PAPALOTLA DE XICOHTENCATL,7,52,0,59
29,6102 YAUHQUEMECAN,5,27,0,32
29,6105 ZACATELCO,31,708,6,745
30,6111 ACATLAN,0,6,0,6
30,6114 ACAYUCAN,10531,1514,10,12055
30,6117 ACTOPAN,1099,53,0,1152
30,6120 ACULA,54,50,0,104
30,6123 ACULTZINGO,26,8,0,34
30,6132 ALTO LUCERO DE GUTIERREZ BARRIOS,116,0,1,117
30,6135 ALTOTONGA,694,8,0,702
30,6138 ALVARADO,0,381,8,389
30,6141 AMATITLAN,1,0,6,7
30,6144 AMATLAN DE LOS REYES,0,12,4,16
30,6147 NARANJOS AMATLAN,0,0,3,3
30,6150 ANGEL R. CABADA,15,100,0,115
30,6153 LA ANTIGUA,3014,672,54,3740
30,6168 ATOYAC,2851,1224,17,4092
30,6171 ATZACAN,28,0,14,42
30,6174 ATZALAN,367,39,27,433
30,6180 AYAHUALULCO,92,0,0,92
30,6186 BENITO JUAREZ,282,382,0,664
30,6189 BOCA DEL RIO,5,392,11,408
30,6195 CAMERINO Z. MENDOZA,23,32,0,55
30,6198 CARRILLO PUERTO,0,12,0,12
30,6201 CATEMACO,3,464,1,468
30,6204 CAZONES DE HERRERA,1924,79,0,2003
30,6205 CERRO AZUL,1,8,0,9
30,6207 CHACALTIANGUIS,21,0,2,23
30,6210 CHALMA,156,23,0,179
30,6216 CHICONAMEL,37,10,0,47
30,6222 CHICONTEPEC,2620,17,0,2637
30,6225 CHINAMECA,266,18,5,289
30,6229 LAS CHOAPAS,210,20,2,232
30,6234 CHONTLA,0,8,0,8
30,6237 CHUMATLAN,56,0,0,56
30,6249 COATEPEC,2870,399,30,3299
30,6252 COATZACOALCOS,3,1305,33,1341
30,6255 COATZINTLA,128,0,6,134
30,6261 COLIPA,22,0,0,22
30,6263 COSAUTLAN DE CARVAJAL,32,21,0,53
30,6264 COMAPA,2275,0,2,2277
30,6267 CORDOBA,2068,830,51,2949
30,6270 COSAMALOAPAN DE CARPIO,3086,814,46,3946
30,6276 COSCOMATEPEC,0,20,16,36
30,6279 COSOLEACAQUE,105,68,0,173
30,6282 COTAXTLA,705,0,2,707
30,6285 COXQUIHUI,178,0,0,178
30,6288 COYUTLA,550,0,0,550
30,6291 CUICHAPA,2291,388,4,2683
30,6294 CUITLAHUAC,29,416,8,453
30,6297 EMILIANO ZAPATA,50,0,12,62
30,6300 ESPINAL,1225,47,0,1272
30,6306 FORTIN,410,455,6,871
30,6309 GUTIERREZ ZAMORA,327,58,1,386
30,6312 HIDALGOTITLAN,77,0,2,79
30,6315 HUATUSCO,639,0,3,642
30,6318 HUAYACOCOTLA,0,15,0,15
30,6321 HUEYAPAN DE OCAMPO,3908,590,6,4504
30,6327 IGNACIO DE LA LLAVE,60,0,0,60
30,6333 IXCATEPEC,147,112,0,259
30,6335 ISLA,2811,740,262,3813
30,6339 IXHUATLAN DEL CAFE,92,22,0,114
30,6342 IXHUATLAN DE MADERO,559,0,0,559
30,6345 IXHUATLANCILLO,0,0,1,1
30,6348 IXMATLAHUACAN,0,0,1,1
30,6351 IXTACZOQUITLAN,1408,173,16,1597
30,6354 JALACINGO,160,6,4,170
30,6357 XALAPA,0,1142,89,1231
30,6363 JALTIPAN,35,44,9,88
30,6366 JAMAPA,81,32,0,113
30,6369 JESUS CARRANZA,171,28,27,226
30,6372 XICO,0,0,16,16
30,6376 JUAN RODRIGUEZ CLARA,456,68,6,530
30,6378 JUCHIQUE DE FERRER,10,0,0,10
30,6384 LERDO DE TEJADA,2584,554,4,3142
30,6393 MANLIO FABIO ALTAMIRANO,35,1,0,36
30,6399 MARTINEZ DE LA TORRE,554,738,24,1316
30,6402 MECATLAN,28,0,0,28
30,6405 MECAYAPAN,107,35,0,142
30,6408 MEDELLIN,11,413,0,424
30,6417 MINATITLAN,501,1311,0,1812
30,6420 MISANTLA,332,381,0,713
30,6423 MIXTLA DE ALTAMIRANO,53,0,0,53
30,6429 NAOLINCO,413,139,0,552
30,6432 NARANJAL,0,381,0,381
30,6435 NAUTLA,25,5,0,30
30,6438 NOGALES,0,4,0,4
30,6441 OLUTA,85,14,0,99
30,6442 OMEALCA,2,21,0,23
30,6444 ORIZABA,0,761,12,773
30,6447 OTATITLAN,6,1,0,7
30,6450 OTEAPAN,0,7,0,7
30,6453 OZULUAMA DE MASCAREÑAS,38,670,124,832
30,6456 PAJAPAN,0,16,0,16
30,6459 PANUCO,5772,4151,272,10195
30,6462 PAPANTLA,8286,506,0,8792
30,6465 PASO DE OVEJAS,369,1,1,371
30,6468 PASO DEL MACHO,1328,290,10,1628
30,6474 PEROTE,3776,423,43,4242
30,6477 PLATON SANCHEZ,127,8,58,193
30,6480 PLAYA VICENTE,91,3,1,95
30,6483 POZA RICA DE HIDALGO,1,764,1,766
30,6486 PUEBLO VIEJO,6,0,0,6
30,6489 PUENTE NACIONAL,315,0,15,330
30,6492 RAFAEL DELGADO,0,86,0,86
30,6495 RAFAEL LUCIO,0,2,1,3
30,6501 SALTABARRANCA,0,13,0,13
30,6507 SAN ANDRES TUXTLA,481,382,0,863
30,6510 SAN JUAN EVANGELISTA,134,58,13,205
30,6513 SANTIAGO TUXTLA,91,1,0,92
30,6516 SAYULA DE ALEMAN,214,87,3,304
30,6522 SOCONUSCO,13,11,0,24
30,6528 SOLEDAD DE DOBLADO,684,0,12,696
30,6531 SOTEAPAN,4080,2,0,4082
30,6534 TAMALIN,14,23,1,38
30,6537 TAMIAHUA,878,107,0,985
30,6540 TAMPICO ALTO,13,2,1,16
30,6546 TANTIMA,0,43,1,44
30,6549 TANTOYUCA,253,696,17,966
30,6552 TATATILA,0,0,2,2
30,6555 CASTILLO DE TEAYO,331,82,1,414
30,6558 TECOLUTLA,204,56,0,260
30,6564 ALAMO TEMAPACHE,1440,54,0,1494
30,6567 TEMPOAL,160,35,35,230
30,6576 RIO BLANCO,0,5,0,5
30,6582 TEOCELO,0,20,18,38
30,6588 TEPETLAN,0,4,0,4
30,6597 JOSE AZUETA,1047,84,4,1135
30,6603 TEXHUACAN,178,0,0,178
30,6606 TEXISTEPEC,336,57,5,398
30,6607 TEZONAPA,5870,2176,564,8610
30,6609 TIERRA BLANCA,1133,1472,58,2663
30,6612 TIHUATLAN,378,1,0,379
30,6618 TLACOJALPAN,12,23,0,35
30,6624 TLACOTALPAN,26,13,4,43
30,6626 TRES VALLES,4134,875,116,5125
30,6627 TLACOTEPEC DE MEJIA,162,0,0,162
30,6630 TLALIXCOYAN,359,31,1,391
30,6636 TLAPACOYAN,2360,3,107,2470
30,6651 TOTUTLA,6,26,0,32
30,6654 TUXPAN,1226,412,11,1649
30,6660 URSULO GALVAN,4529,677,9,5215
30,6663 VEGA DE ALATORRE,33,16,4,53
30,6666 VERACRUZ,7105,1713,101,8919
30,6669 LAS VIGAS DE RAMIREZ,3,66,15,84
30,6672 VILLA ALDAMA,0,0,1,1
30,6678 YANGA,0,0,1,1
30,6681 YECUATLA,12,11,0,23
30,6686 UXPANAPA,17,5,1,23
30,6687 ZARAGOZA,11,0,0,11
30,6688 TATAHUICAPAN DE JUAREZ,1,30,0,31
30,6689 AGUA DULCE,0,1,0,1
30,6690 ZENTLA,170,10,1,181
30,6691 NANCHITAL DE LAZARO CARDENAS DEL RIO,0,51,0,51
30,6693 ZONGOLICA,1124,1,12,1137
30,6696 ZONTECOMATLAN DE LOPEZ Y FUENTES,16,0,0,16
30,6698 EL HIGO,670,961,79,1710
31,6702 ABALA,0,23,0,23
31,6705 ACANCEH,3,0,3,6
31,6708 AKIL,17,34,0,51
31,6711 BACA,1,0,0,1
31,6717 BUCTZOTZ,2,0,0,2
31,6720 CACALCHEN,6,0,0,6
31,6723 CALOTMUL,1,0,0,1
31,6732 CELESTUN,0,0,62,62
31,6738 CHACSINKIN,25,0,0,25
31,6741 CHANKOM,151,0,0,151
31,6744 CHAPAB,0,10,0,10
31,6747 CHEMAX,285,6,1,292
31,6750 CHICHIMILA,4,16,0,20
31,6756 CHIKINDZONOT,6,0,0,6
31,6759 CHOCHOLA,1,0,0,1
31,6765 CONKAL,1,0,0,1
31,6774 DZAN,1,25,0,26
31,6777 DZEMUL,0,8,0,8
31,6783 DZILAM DE BRAVO,40,0,0,40
31,6786 DZILAM GONZALEZ,1,0,0,1
31,6789 DZITAS,15,74,0,89
31,6795 ESPITA,22,3,1,26
31,6798 HALACHO,14,3,1,18
31,6804 HOCTUN,2,0,0,2
31,6813 HUNUCMA,0,0,8,8
31,6819 IZAMAL,193,2,4,199
31,6822 KANASIN,9,23,6,38
31,6834 KINCHIL,0,0,14,14
31,6843 MAXCANU,16,1,0,17
31,6849 MERIDA,229,10753,794,11776
31,6855 MOTUL,95,10,0,105
31,6858 MUNA,41,124,0,165
31,6867 OXKUTZCAB,440,290,1,731
31,6870 PANABA,3,0,0,3
31,6873 PETO,63,155,0,218
31,6876 PROGRESO,2517,261,165,2943
31,6882 RIO LAGARTOS,71,0,0,71
31,6885 SACALUM,3,2542,0,2545
31,6891 SAN FELIPE,36,0,28,64
31,6903 SINANCHE,3,0,0,3
31,6909 SUCILA,107,1,0,108
31,6924 TEABO,1,0,0,1
31,6933 TEKAX,3519,667,74,4260
31,6936 TEKIT,0,1,0,1
31,6942 TEKOM,0,6,0,6
31,6954 TEMOZON,0,0,1,1
31,6957 TEPAKAN,1,0,0,1
31,6966 TICUL,2602,3402,1,6005
31,6972 TINUM,24,18,0,42
31,6975 TIXCACALCUPUL,1099,2,0,1101
31,6978 TIXKOKOB,30,3,0,33
31,6981 TIXMEHUAC,0,1,3,4
31,6987 TIZIMIN,4732,2639,40,7411
31,6990 TUNKAS,14,0,0,14
31,6993 TZUCACAB,132,72,3,207
31,6996 UAYMA,24,0,0,24
31,7002 UMAN,1106,350,21,1477
31,7005 VALLADOLID,6174,7000,56,13230
31,7008 XOCCHEL,0,43,0,43
31,7011 YAXCABA,0,17,0,17
32,7029 BENITO JUAREZ,18,2,4,24
32,7032 CALERA,417,11,26,454
32,7035 CAÑITAS DE FELIPE PESCADOR,7,0,5,12
32,7047 FRESNILLO,9202,592,32,9826
32,7052 GENERAL ENRIQUE ESTRADA,0,0,1,1
32,7054 GENERAL FRANCISCO R. MURGUIA,199,11,0,210
32,7056 GENERAL PANFILO NATERA,147,0,1,148
32,7057 GUADALUPE,739,1190,3,1932
32,7062 JALPA,772,0,0,772
32,7065 JEREZ,137,99,2,238
32,7071 JUAN ALDAMA,206,15,0,221
32,7077 LORETO,87,179,25,291
32,7080 LUIS MOYA,4,33,2,39
32,7083 MAZAPIL,6,0,0,6
32,7092 MIGUEL AUZA,4751,324,59,5134
32,7098 MONTE ESCOBEDO,402,8,11,421
32,7101 MORELOS,199,47,6,252
32,7113 NORIA DE ANGELES,4,0,0,4
32,7116 OJOCALIENTE,234,193,19,446
32,7119 PANUCO,678,29,10,717
32,7122 PINOS,820,156,3,979
32,7128 RIO GRANDE,651,392,33,1076
32,7131 SAIN ALTO,222,245,0,467
32,7134 SOMBRERETE,1848,573,38,2459
32,7140 TABASCO,0,0,4,4
32,7143 TEPECHITLAN,0,3,3,6
32,7146 TEPETONGO,1,1,0,2
32,7152 TLALTENANGO DE SANCHEZ ROMAN,143,13,10,166
32,7155 VALPARAISO,0,2,6,8
32,7158 VETAGRANDE,76,0,9,85
32,7161 VILLA DE COS,8991,296,159,9446
32,7164 VILLA GARCIA,0,34,0,34
32,7167 VILLA GONZALEZ ORTEGA,382,2,0,384
32,7170 VILLA HIDALGO,895,3,0,898
32,7173 VILLANUEVA,0,201,1,202
32,7175 TRANCOSO,3,24,0,27
32,7176 ZACATECAS,824,1601,5,2430
