cve_edo,Municipio,PD1,PD2,PD3,Total
1,AGUASCALIENTES,20,14,86,120
1,ASIENTOS,2,8,2,12
1,CALVILLO,0,7,7,14
1,COSIO,3,10,10,23
1,JESUS MARIA,2,16,18,36
1,PABELLON DE ARTEAGA,27,68,96,191
1,RINCON DE ROMOS,5,48,35,88
1,SAN JOSE DE GRACIA,7,16,9,32
1,TEPEZALA,3,31,20,54
1,EL LLANO,1,3,3,7
1,SAN FRANCISCO DE LOS ROMO,12,49,43,104
2,ENSENADA,7,17,90,114
2,MEXICALI,637,634,930,2201
2,TECATE,0,1,6,7
2,TIJUANA,0,1,8,9
3,LOS CABOS,3,19,39,61
3,COMONDU,27,106,65,198
3,MULEGE,33,15,12,60
3,LA PAZ,0,9,25,34
3,LORETO,0,11,6,17
4,CALKINI,136,12,3,151
4,CAMPECHE,30,26,57,113
4,CARMEN,9,11,22,42
4,CHAMPOTON,23,23,29,75
4,ESCARCEGA,141,10,2,153
4,HECELCHAKAN,18,10,9,37
4,CANDELARIA,8,7,2,17
4,HOPELCHEN,23,87,90,200
4,PALIZADA,7,25,33,65
4,CALAKMUL,11,1,0,12
4,TENABO,8,2,5,15
7,ACACOYAGUA,3,0,0,3
7,ACALA,14,10,0,24
7,ACAPETAHUA,3,1,0,4
7,ARRIAGA,17,21,0,38
7,BERRIOZABAL,7,3,2,12
7,BOCHIL,3,4,0,7
7,EL BOSQUE,5,0,0,5
7,CACAHOATAN,0,1,0,1
7,CATAZAJA,2,0,0,2
7,CHENALHO,4,0,0,4
7,CHIAPA DE CORZO,205,73,5,283
7,CHIAPILLA,2,2,0,4
7,CHICOASEN,0,1,0,1
7,CHICOMUSELO,0,0,2,2
7,CHILON,3,0,0,3
7,CINTALAPA,98,28,7,133
7,COMITAN DE DOMINGUEZ,129,29,1,159
7,LA CONCORDIA,63,16,12,91
7,COPAINALA,0,1,0,1
7,ESCUINTLA,3,0,0,3
7,FRANCISCO LEON,1,0,0,1
7,FRONTERA COMALAPA,10,2,1,13
7,HUEHUETAN,2,1,4,7
7,HUITIUPAN,0,1,0,1
7,HUIXTLA,136,25,3,164
7,LA INDEPENDENCIA,6,1,0,7
7,IXTAPA,11,1,1,13
7,JIQUIPILAS,9,6,6,21
7,JITOTOL,7,1,0,8
7,JUAREZ,1,3,1,5
7,LARRAINZAR,3,0,0,3
7,LA LIBERTAD,1,0,1,2
7,MAPASTEPEC,127,28,0,155
7,LAS MARGARITAS,1,0,0,1
7,MAZATAN,11,5,5,21
7,MOTOZINTLA,13,1,0,14
7,NICOLAS RUIZ,1,0,0,1
7,OCOSINGO,14,2,0,16
7,OCOZOCOAUTLA DE ESPINOSA,16,10,4,30
7,PALENQUE,14,18,0,32
7,PICHUCALCO,2,2,0,4
7,PIJIJIAPAN,12,16,3,31
7,VILLA COMALTITLAN,3,0,2,5
7,PUEBLO NUEVO SOLISTAHUACAN,1,0,0,1
7,REFORMA,0,2,0,2
7,SALTO DE AGUA,0,2,0,2
7,SAN CRISTOBAL DE LAS CASAS,5,3,5,13
7,SAN FERNANDO,9,6,0,15
7,SILTEPEC,5,0,0,5
7,SIMOJOVEL,10,5,0,15
7,SOCOLTENANGO,17,10,5,32
7,SOYALO,10,1,0,11
7,SUCHIAPA,21,2,3,26
7,SUCHIATE,2,1,0,3
7,SUNUAPA,1,0,0,1
7,TAPACHULA,17,59,26,102
7,TAPILULA,0,2,0,2
7,TECPATAN,8,1,0,9
7,TEOPISCA,0,0,2,2
7,TILA,3,3,0,6
7,TONALA,202,133,16,351
7,TOTOLAPA,5,1,0,6
7,LA TRINITARIA,4,0,1,5
7,TUXTLA GUTIERREZ,37,5,22,64
7,TUXTLA CHICO,1,0,1,2
7,TUZANTAN,3,1,1,5
7,VENUSTIANO CARRANZA,29,16,0,45
7,ANGEL ALBINO CORZO,26,5,4,35
7,VILLAFLORES,407,192,7,606
7,YAJALON,3,11,0,14
7,SAN LUCAS,4,1,0,5
7,ZINACANTAN,1,0,0,1
7,BENEMERITO DE LAS AMERICAS,2,0,0,2
7,MARQUES DE COMILLAS,4,0,0,4
7,VILLA CORZO,87,57,8,152
8,ALDAMA,4,9,40,53
8,ALLENDE,0,3,16,19
8,AQUILES SERDAN,0,0,1,1
8,ASCENSION,21,12,25,58
8,BACHINIVA,4,1,1,6
8,BALLEZA,0,0,2,2
8,BATOPILAS,3,2,0,5
8,BOCOYNA,1,1,1,3
8,BUENAVENTURA,7,91,131,229
8,CAMARGO,6,9,61,76
8,CARICHI,0,0,1,1
8,CASAS GRANDES,0,3,9,12
8,CHIHUAHUA,21,15,101,137
8,COYAME DEL SOTOL,3,2,5,10
8,LA CRUZ,2,0,1,3
8,CUAUHTEMOC,14,134,280,428
8,CUSIHUIRIACHI,0,5,9,14
8,DELICIAS,5,6,110,121
8,DR. BELISARIO DOMINGUEZ,1,0,0,1
8,GALEANA,1,2,12,15
8,SANTA ISABEL,1,0,0,1
8,GRAN MORELOS,0,1,0,1
8,GUACHOCHI,20,16,0,36
8,GUADALUPE,1,1,0,2
8,GUADALUPE Y CALVO,23,11,0,34
8,GUAZAPARES,0,0,1,1
8,GUERRERO,1,1,17,19
8,HIDALGO DEL PARRAL,0,0,47,47
8,JANOS,2,6,19,27
8,JIMENEZ,3,3,44,50
8,JUAREZ,1,0,32,33
8,JULIMES,5,3,15,23
8,MADERA,9,1,2,12
8,MEOQUI,4,8,34,46
8,NAMIQUIPA,7,18,65,90
8,NONOAVA,0,2,1,3
8,NUEVO CASAS GRANDES,0,7,17,24
8,OCAMPO,1,2,0,3
8,OJINAGA,1,16,63,80
8,PRAXEDIS G. GUERRERO,1,0,0,1
8,RIVA PALACIO,2,3,7,12
8,ROSALES,4,8,20,32
8,ROSARIO,0,0,1,1
8,SAN FRANCISCO DE BORJA,1,0,1,2
8,SAN FRANCISCO DE CONCHOS,3,5,5,13
8,SANTA BARBARA,0,1,2,3
8,SATEVO,2,0,6,8
8,SAUCILLO,1,3,32,36
8,EL TULE,0,2,1,3
8,AHUMADA,12,28,63,103
8,CORONADO,0,0,7,7
8,LOPEZ,0,0,14,14
8,MATAMOROS,0,0,4,4
8,VALLE DE ZARAGOZA,0,0,13,13
5,ABASOLO,0,1,0,1
5,ACUÑA,0,1,1,2
5,ALLENDE,0,2,2,4
5,ARTEAGA,2,4,15,21
5,CASTAÑOS,1,0,2,3
5,CUATRO CIENEGAS,0,1,5,6
5,FRANCISCO I. MADERO,5,13,34,52
5,GENERAL CEPEDA,10,3,2,15
5,JIMENEZ,0,0,1,1
5,LAMADRID,0,5,4,9
5,MATAMOROS,9,15,41,65
5,MONCLOVA,0,3,1,4
5,MORELOS,0,1,1,2
5,MUZQUIZ,1,0,1,2
5,NADADORES,0,6,0,6
5,NAVA,0,2,1,3
5,OCAMPO,0,2,0,2
5,PARRAS,3,2,5,10
5,PIEDRAS NEGRAS,0,2,0,2
5,PROGRESO,0,0,1,1
5,RAMOS ARIZPE,0,2,37,39
5,SABINAS,0,1,6,7
5,SALTILLO,3,8,46,57
5,SAN JUAN DE SABINAS,0,2,1,3
5,SAN PEDRO,6,16,78,100
5,TORREON,13,9,186,208
5,VIESCA,1,3,7,11
5,FRONTERA,0,0,1,1
5,ZARAGOZA,0,1,4,5
6,ARMERIA,8,5,5,18
6,COLIMA,19,13,120,152
6,COMALA,2,0,0,2
6,COQUIMATLAN,4,1,0,5
6,CUAUHTEMOC,95,34,10,139
6,IXTLAHUACAN,3,3,0,6
6,MANZANILLO,11,5,14,30
6,MINATITLAN,2,1,1,4
6,TECOMAN,16,29,48,93
6,VILLA DE ALVAREZ,1,1,12,14
9,AZCAPOTZALCO,0,2,9,11
9,MIGUEL HIDALGO,0,1,27,28
9,COYOACAN,0,0,4,4
9,CUAJIMALPA DE MORELOS,1,0,38,39
9,GUSTAVO A. MADERO,0,0,6,6
9,IZTACALCO,0,0,2,2
9,IZTAPALAPA,4,0,70,74
9,CUAUHTEMOC,0,0,9,9
9,LA MAGDALENA CONTRERAS,0,0,1,1
9,MILPA ALTA,0,7,1,8
9,ALVARO OBREGON,0,0,75,75
9,BENITO JUAREZ,0,0,14,14
9,TLALPAN,0,1,8,9
9,XOCHIMILCO,0,8,0,8
10,CANATLAN,10,8,17,35
10,CUENCAME,2,11,15,28
10,DURANGO,37,128,124,289
10,GENERAL SIMON BOLIVAR,3,3,3,9
10,GOMEZ PALACIO,6,10,101,117
10,GUADALUPE VICTORIA,19,93,49,161
10,GUANACEVI,10,4,4,18
10,HIDALGO,0,2,3,5
10,INDE,0,1,10,11
10,LERDO,21,14,34,69
10,MAPIMI,18,10,22,50
10,MEZQUITAL,0,0,1,1
10,NAZAS,2,0,5,7
10,NOMBRE DE DIOS,5,4,10,19
10,OCAMPO,5,1,7,13
10,EL ORO,2,4,3,9
10,PANUCO DE CORONADO,3,4,12,19
10,PEÑON BLANCO,0,1,7,8
10,POANAS,12,17,8,37
10,PUEBLO NUEVO,7,0,0,7
10,RODEO,1,1,0,2
10,SAN BERNARDO,0,1,0,1
10,SAN DIMAS,10,1,1,12
10,SAN JUAN DE GUADALUPE,0,3,0,3
10,SAN JUAN DEL RIO,0,4,0,4
10,SAN LUIS DEL CORDERO,0,0,1,1
10,SAN PEDRO DEL GALLO,0,0,1,1
10,SANTA CLARA,1,0,1,2
10,SANTIAGO PAPASQUIARO,41,0,23,64
10,SUCHIL,0,2,0,2
10,TAMAZULA,6,3,0,9
10,TEPEHUANES,13,3,3,19
10,TLAHUALILO,2,2,16,20
10,TOPIA,2,0,0,2
10,NUEVO IDEAL,7,23,11,41
10,VICENTE GUERRERO,12,3,3,18
11,ABASOLO,23,96,69,188
11,ACAMBARO,26,84,43,153
11,SAN MIGUEL DE ALLENDE,0,20,7,27
11,APASEO EL ALTO,15,11,6,32
11,APASEO EL GRANDE,6,58,197,261
11,MANUEL DOBLADO,19,21,172,212
11,CELAYA,5,70,230,305
11,COMONFORT,7,62,35,104
11,CORTAZAR,7,27,41,75
11,CUERAMARO,2,3,4,9
11,DOLORES HIDALGO,4,15,37,56
11,DOCTOR MORA,3,11,40,54
11,GUANAJUATO,0,1,1,2
11,HUANIMARO,48,31,35,114
11,IRAPUATO,23,54,191,268
11,JARAL DEL PROGRESO,14,17,40,71
11,JERECUARO,0,0,3,3
11,LEON,26,17,175,218
11,MOROLEON,14,7,147,168
11,OCAMPO,0,1,5,6
11,PENJAMO,81,254,321,656
11,PUEBLO NUEVO,0,9,13,22
11,PURISIMA DEL RINCON,12,4,97,113
11,ROMITA,12,11,17,40
11,SAN DIEGO DE LA UNION,1,3,3,7
11,SAN FRANCISCO DEL RINCON,17,2,8,27
11,SAN JOSE ITURBIDE,10,67,117,194
11,SAN LUIS DE LA PAZ,31,140,193,364
11,SALAMANCA,26,89,107,222
11,SALVATIERRA,75,260,242,577
11,SAN FELIPE,41,323,114,478
11,SANTA CATARINA,0,4,3,7
11,SANTIAGO MARAVATIO,8,7,5,20
11,SILAO,14,5,22,41
11,SANTA CRUZ DE JUVENTINO ROSAS,16,172,289,477
11,TARANDACUAO,0,2,11,13
11,TARIMORO,0,4,14,18
11,TIERRA BLANCA,1,5,11,17
11,URIANGATO,17,37,252,306
11,VALLE DE SANTIAGO,39,97,127,263
11,VICTORIA,0,6,0,6
11,VILLAGRAN,12,111,129,252
11,XICHU,0,1,3,4
11,YURIRIA,29,128,217,374
12,ACAPULCO DE JUAREZ,10,0,2,12
12,ARCELIA,2,3,1,6
12,ATOYAC DE ALVAREZ,28,9,1,38
12,AZOYU,2,0,0,2
12,BENITO JUAREZ,0,2,0,2
12,CHILAPA DE ALVAREZ,22,5,1,28
12,CHILPANCINGO DE LOS BRAVO,6,2,4,12
12,COAHUAYUTLA DE JOSE MARIA IZAZAGA,0,0,1,1
12,COCULA,1,0,0,1
12,COPALA,1,0,0,1
12,COPALILLO,1,0,0,1
12,COYUCA DE BENITEZ,0,2,1,3
12,COYUCA DE CATALAN,3,1,2,6
12,CUAJINICUILAPA,2,2,5,9
12,HUAMUXTITLAN,1,0,0,1
12,HUITZUCO DE LOS FIGUEROA,11,1,0,12
12,IGUALA DE LA INDEPENDENCIA,14,12,41,67
12,ZIHUATANEJO DE AZUETA,6,8,12,26
12,MALINALTEPEC,2,0,0,2
12,MARTIR DE CUILAPAN,1,1,0,2
12,OMETEPEC,1,2,0,3
12,PETATLAN,0,4,1,5
12,PILCAYA,0,0,1,1
12,PUNGARABATO,12,5,0,17
12,SAN LUIS ACATLAN,2,0,0,2
12,SAN MARCOS,0,1,0,1
12,SAN MIGUEL TOTOLAPAN,1,0,0,1
12,TAXCO DE ALARCON,11,0,0,11
12,TECPAN DE GALEANA,25,9,0,34
12,TELOLOAPAN,4,1,1,6
12,TEPECOACUILCO DE TRUJANO,3,0,0,3
12,TETIPAC,1,0,0,1
12,TIXTLA DE GUERRERO,2,10,0,12
12,TLALCHAPA,1,3,0,4
12,TLAPA DE COMONFORT,0,0,13,13
12,TLAPEHUALA,0,1,0,1
12,LA UNION DE ISIDORO MONTES DE OCA,1,0,0,1
12,XALPATLAHUAC,1,0,0,1
12,XOCHISTLAHUACA,4,0,0,4
12,ZAPOTITLAN TABLAS,1,0,0,1
12,ZIRANDARO,2,4,0,6
13,ACATLAN,1,5,0,6
13,ACAXOCHITLAN,4,4,3,11
13,ACTOPAN,2,10,5,17
13,AGUA BLANCA DE ITURBIDE,5,4,1,10
13,AJACUBA,1,4,0,5
13,ALFAJAYUCAN,4,1,1,6
13,ALMOLOYA,7,10,7,24
13,APAN,33,76,20,129
13,ATITALAQUIA,1,4,20,25
13,ATLAPEXCO,5,7,0,12
13,CALNALI,4,3,0,7
13,CARDONAL,0,1,0,1
13,CHAPANTONGO,0,1,0,1
13,CHAPULHUACAN,2,0,0,2
13,CHILCUAUTLA,0,1,0,1
13,CUAUTEPEC DE HINOJOSA,7,20,3,30
13,EMILIANO ZAPATA,2,11,2,15
13,EPAZOYUCAN,9,17,0,26
13,FRANCISCO I. MADERO,1,4,2,7
13,HUASCA DE OCAMPO,1,3,2,6
13,HUAUTLA,1,5,0,6
13,HUEHUETLA,0,2,0,2
13,HUEJUTLA DE REYES,13,7,0,20
13,HUICHAPAN,9,11,2,22
13,IXMIQUILPAN,24,38,2,64
13,JALTOCAN,1,1,0,2
13,JUAREZ HIDALGO,1,0,0,1
13,METEPEC,16,4,12,32
13,SAN AGUSTIN METZQUITITLAN,0,2,0,2
13,METZTITLAN,0,4,0,4
13,MINERAL DE LA REFORMA,66,134,2,202
13,MINERAL DEL CHICO,3,0,0,3
13,MINERAL DEL MONTE,2,3,0,5
13,MIXQUIAHUALA DE JUAREZ,6,8,11,25
13,NOPALA DE VILLAGRAN,0,1,1,2
13,OMITLAN DE JUAREZ,0,2,0,2
13,SAN FELIPE ORIZATLAN,0,1,0,1
13,PACHUCA DE SOTO,3,5,20,28
13,PISAFLORES,2,0,0,2
13,PROGRESO DE OBREGON,2,3,4,9
13,SAN AGUSTIN TLAXIACA,6,24,1,31
13,SAN BARTOLO TUTOTEPEC,1,0,0,1
13,SAN SALVADOR,1,2,0,3
13,SANTIAGO DE ANAYA,0,2,0,2
13,SANTIAGO TULANTEPEC DE LUGO GUERRERO,3,9,1,13
13,SINGUILUCAN,8,11,4,23
13,TASQUILLO,0,5,0,5
13,TECOZAUTLA,0,1,4,5
13,TENANGO DE DORIA,8,0,0,8
13,TEPEAPULCO,6,10,1,17
13,TEPEJI DEL RIO DE OCAMPO,25,15,1,41
13,TEZONTEPEC DE ALDAMA,0,0,2,2
13,VILLA DE TEZONTEPEC,0,14,2,16
13,TIANGUISTENGO,1,0,0,1
13,TIZAYUCA,8,4,37,49
13,TLAHUELILPAN,1,0,1,2
13,TLAHUILTEPA,0,1,0,1
13,TLANCHINOL,3,0,1,4
13,TLAXCOAPAN,3,4,3,10
13,TOLCAYUCA,3,2,45,50
13,TULA DE ALLENDE,17,35,0,52
13,TULANCINGO DE BRAVO,6,31,34,71
13,YAHUALICA,1,2,0,3
13,ZACUALTIPAN DE ANGELES,2,2,0,4
13,ZAPOTLAN DE JUAREZ,15,27,0,42
13,ZEMPOALA,4,26,2,32
14,ACATIC,11,4,152,167
14,ACATLAN DE JUAREZ,8,5,1,14
14,AHUALULCO DE MERCADO,74,17,11,102
14,AMATITAN,1,10,8,19
14,AMECA,137,146,180,463
14,SAN JUANITO DE ESCOBEDO,14,0,0,14
14,ARANDAS,7,41,220,268
14,EL ARENAL,3,10,28,41
14,ATEMAJAC DE BRIZUELA,6,1,0,7
14,ATENGO,6,7,3,16
14,ATENGUILLO,7,3,0,10
14,ATOTONILCO EL ALTO,31,39,143,213
14,ATOYAC,0,0,1,1
14,AUTLAN DE NAVARRO,14,2,6,22
14,AYOTLAN,6,33,103,142
14,AYUTLA,6,0,1,7
14,LA BARCA,28,95,84,207
14,CASIMIRO CASTILLO,15,3,9,27
14,CHAPALA,1,6,1,8
14,CHIQUILISTLAN,2,0,0,2
14,CIHUATLAN,3,1,4,8
14,ZAPOTLAN EL GRANDE,0,4,31,35
14,COCULA,19,11,5,35
14,COLOTLAN,0,0,1,1
14,CONCEPCION DE BUENOS AIRES,0,0,1,1
14,CUAUTITLAN DE GARCIA BARRAGAN,3,3,1,7
14,CUQUIO,224,13,1,238
14,DEGOLLADO,1,4,3,8
14,ENCARNACION DE DIAZ,9,44,108,161
14,ETZATLAN,95,36,67,198
14,EL GRULLO,10,1,1,12
14,GUACHINANGO,7,4,0,11
14,GUADALAJARA,2,103,122,227
14,HOSTOTIPAQUILLO,11,0,2,13
14,HUEJUCAR,1,0,0,1
14,HUEJUQUILLA EL ALTO,3,0,3,6
14,LA HUERTA,3,0,0,3
14,IXTLAHUACAN DE LOS MEMBRILLOS,4,11,4,19
14,IXTLAHUACAN DEL RIO,34,11,10,55
14,JALOSTOTITLAN,4,32,24,60
14,JAMAY,7,3,18,28
14,JESUS MARIA,2,1,42,45
14,JILOTLAN DE LOS DOLORES,5,0,0,5
14,JOCOTEPEC,12,7,11,30
14,JUANACATLAN,1,0,7,8
14,LAGOS DE MORENO,12,31,33,76
14,EL LIMON,1,0,0,1
14,MAGDALENA,12,8,24,44
14,MASCOTA,4,8,0,12
14,MEZQUITIC,3,0,0,3
14,OCOTLAN,25,13,20,58
14,OJUELOS DE JALISCO,3,0,1,4
14,PIHUAMO,15,4,0,19
14,PONCITLAN,6,21,44,71
14,PUERTO VALLARTA,0,3,1,4
14,VILLA PURIFICACION,9,2,0,11
14,QUITUPAN,3,1,0,4
14,SAN DIEGO DE ALEJANDRIA,2,0,0,2
14,SAN JUAN DE LOS LAGOS,16,73,95,184
14,GOMEZ FARIAS,3,1,3,7
14,EL SALTO,1,1,21,23
14,SAN JULIAN,3,1,0,4
14,SAN MARCOS,3,9,1,13
14,SAN MARTIN HIDALGO,57,63,26,146
14,SAN MIGUEL EL ALTO,0,9,9,18
14,SAN SEBASTIAN DEL OESTE,3,1,0,4
14,SAYULA,1,8,12,21
14,TALA,26,75,98,199
14,TALPA DE ALLENDE,10,1,0,11
14,TAMAZULA DE GORDIANO,62,24,58,144
14,TAPALPA,9,6,6,21
14,TECALITLAN,5,2,4,11
14,TECOLOTLAN,2,2,0,4
14,TENAMAXTLAN,8,3,0,11
14,TEOCALTICHE,8,10,43,61
14,TEOCUITATLAN DE CORONA,0,2,2,4
14,TEPATITLAN DE MORELOS,5,19,52,76
14,TEQUILA,12,60,79,151
14,TEUCHITLAN,8,7,4,19
14,TLAJOMULCO DE ZUÑIGA,48,46,8,102
14,TLAQUEPAQUE,1,1,3,5
14,TOLIMAN,2,1,0,3
14,TOMATLAN,14,4,6,24
14,TONALA,2,0,1,3
14,TONAYA,1,0,3,4
14,TONILA,44,1,2,47
14,TOTATICHE,1,16,1,18
14,TOTOTLAN,8,13,61,82
14,TUXCACUESCO,1,0,2,3
14,TUXPAN,8,15,82,105
14,UNION DE SAN ANTONIO,18,2,8,28
14,UNION DE TULA,12,1,0,13
14,VALLE DE GUADALUPE,5,13,5,23
14,SAN GABRIEL,3,4,2,9
14,VILLA CORONA,6,4,2,12
14,VILLA GUERRERO,0,1,0,1
14,VILLA HIDALGO,5,0,1,6
14,YAHUALICA DE GONZALEZ GALLO,2,0,0,2
14,ZACOALCO DE TORRES,0,2,2,4
14,ZAPOPAN,3,23,123,149
14,ZAPOTILTIC,39,22,196,257
14,ZAPOTITLAN DE VADILLO,7,1,1,9
14,ZAPOTLAN DEL REY,3,5,8,16
14,ZAPOTLANEJO,10,48,125,183
15,ACAMBAY,1,2,1,4
15,ACOLMAN,0,3,12,15
15,ACULCO,1,2,7,10
15,ALMOLOYA DE ALQUISIRAS,0,1,0,1
15,ALMOLOYA DE JUAREZ,3,24,14,41
15,AMANALCO,0,5,3,8
15,AMECAMECA,0,1,52,53
15,APAXCO,2,1,0,3
15,ATENCO,0,1,0,1
15,ATIZAPAN,0,0,6,6
15,ATLACOMULCO,10,5,5,20
15,ATLAUTLA,0,1,1,2
15,AXAPUSCO,0,2,0,2
15,AYAPANGO,2,1,0,3
15,CALIMAYA,0,0,2,2
15,CAPULHUAC,0,1,1,2
15,CHALCO,0,1,1,2
15,CHAPA DE MOTA,1,2,0,3
15,CHIAUTLA,0,1,0,1
15,CHICONCUAC,0,0,2,2
15,COATEPEC HARINAS,1,4,1,6
15,COYOTEPEC,4,11,0,15
15,CUAUTITLAN IZCALLI,0,1,32,33
15,DONATO GUERRA,0,0,1,1
15,ECATEPEC DE MORELOS,0,1,23,24
15,HUEHUETOCA,4,6,0,10
15,HUEYPOXTLA,1,0,0,1
15,HUIXQUILUCAN,1,0,0,1
15,IXTAPALUCA,0,1,1,2
15,IXTLAHUACA,2,19,7,28
15,XALATLACO,0,2,2,4
15,JILOTEPEC,3,7,4,14
15,JIQUIPILCO,4,9,3,16
15,JOCOTITLAN,3,7,6,16
15,JOQUICINGO,0,0,2,2
15,JUCHITEPEC,0,2,2,4
15,LERMA,0,1,0,1
15,MELCHOR OCAMPO,0,2,0,2
15,METEPEC,0,1,1,2
15,MORELOS,1,1,0,2
15,NAUCALPAN DE JUAREZ,0,0,44,44
15,NEXTLALPAN,0,2,0,2
15,NICOLAS ROMERO,0,2,0,2
15,NOPALTEPEC,1,4,2,7
15,OCOYOACAC,0,0,34,34
15,OCUILAN,0,3,4,7
15,EL ORO,0,1,1,2
15,OTUMBA,0,5,0,5
15,OTZOLOAPAN,0,1,0,1
15,OTZOLOTEPEC,1,4,0,5
15,OZUMBA,0,0,1,1
15,PAPALOTLA,0,0,4,4
15,LA PAZ,0,0,10,10
15,POLOTITLAN,0,1,1,2
15,RAYON,1,0,0,1
15,SAN FELIPE DEL PROGRESO,1,4,3,8
15,SAN MARTIN DE LAS PIRAMIDES,0,2,0,2
15,SAN SIMON DE GUERRERO,0,0,1,1
15,SOYANIQUILPAN DE JUAREZ,1,0,0,1
15,TECAMAC,1,6,4,11
15,TEJUPILCO,2,1,1,4
15,TEMASCALAPA,1,14,0,15
15,TEMASCALCINGO,1,5,0,6
15,TEMASCALTEPEC,0,10,3,13
15,TEMOAYA,2,4,3,9
15,TENANCINGO,16,5,7,28
15,TENANGO DEL AIRE,0,1,5,6
15,TENANGO DEL VALLE,0,1,14,15
15,TEOLOYUCAN,5,6,3,14
15,TEOTIHUACAN,1,3,0,4
15,TEPETLIXPA,0,0,1,1
15,TEQUIXQUIAC,0,0,1,1
15,TEXCALTITLAN,0,1,0,1
15,TEXCOCO,98,5,24,127
15,TIANGUISTENCO,0,2,13,15
15,TIMILPAN,0,2,0,2
15,TLALNEPANTLA DE BAZ,0,0,18,18
15,TLATLAYA,0,1,0,1
15,TOLUCA,1,4,82,87
15,TONATICO,0,1,0,1
15,TULTEPEC,1,0,0,1
15,TULTITLAN,0,7,23,30
15,VALLE DE BRAVO,0,0,1,1
15,VILLA DE ALLENDE,1,4,5,10
15,VILLA DEL CARBON,0,1,2,3
15,VILLA GUERRERO,0,1,7,8
15,VILLA VICTORIA,3,4,1,8
15,XONACATLAN,0,0,1,1
15,ZACUALPAN,0,0,2,2
15,ZINACANTEPEC,0,16,5,21
15,ZUMPAHUACAN,0,1,2,3
15,ZUMPANGO,1,5,5,11
15,LUVIANOS,0,2,1,3
15,SAN JOSE DEL RINCON,0,11,8,19
16,ACUITZIO,2,2,6,10
16,AGUILILLA,0,2,0,2
16,ALVARO OBREGON,9,4,12,25
16,ANGAMACUTIRO,18,8,0,26
16,APATZINGAN,16,26,3,45
16,APORO,0,0,1,1
16,AQUILA,2,0,0,2
16,ARIO,7,34,22,63
16,BRISEÑAS,11,3,5,19
16,BUENAVISTA,26,16,6,48
16,CARACUARO,0,1,0,1
16,CHARAPAN,4,33,10,47
16,CHARO,0,1,0,1
16,CHAVINDA,3,15,3,21
16,CHILCHOTA,1,33,2,36
16,CHUCANDIRO,0,0,2,2
16,CHURINTZIO,4,1,4,9
16,CHURUMUCO,4,2,0,6
16,COAHUAYANA,3,9,0,12
16,COALCOMAN DE VAZQUEZ PALLARES,0,0,1,1
16,COENEO,0,2,5,7
16,CONTEPEC,5,2,2,9
16,COPANDARO,0,2,0,2
16,COTIJA,3,2,1,6
16,CUITZEO,4,2,26,32
16,ECUANDUREO,0,1,5,6
16,EPITACIO HUERTA,0,2,4,6
16,ERONGARICUARO,4,16,8,28
16,GABRIEL ZAMORA,23,16,3,42
16,HIDALGO,1,0,4,5
16,LA HUACANA,0,1,0,1
16,HUANDACAREO,4,2,7,13
16,HUANIQUEO,1,0,1,2
16,HUETAMO,6,5,4,15
16,HUIRAMBA,0,6,1,7
16,INDAPARAPEO,3,13,0,16
16,IRIMBO,1,0,0,1
16,IXTLAN,2,13,14,29
16,JACONA,11,35,77,123
16,JIMENEZ,6,1,15,22
16,JIQUILPAN,2,8,14,24
16,JOSE SIXTO VERDUZCO,32,17,30,79
16,JUAREZ,1,0,0,1
16,MADERO,0,2,4,6
16,MARAVATIO,6,2,3,11
16,MORELIA,13,22,24,59
16,MORELOS,3,0,0,3
16,NAHUATZEN,1,2,0,3
16,NUEVO PARANGARICUTIRO,0,70,2,72
16,NUEVO URECHO,0,1,0,1
16,NUMARAN,8,6,3,17
16,PAJACUARAN,5,77,124,206
16,PANINDICUARO,6,0,0,6
16,PARACHO,1,4,0,5
16,PARACUARO,2,10,2,14
16,PATZCUARO,17,44,39,100
16,PENJAMILLO,7,5,3,15
16,PERIBAN,6,40,50,96
16,LA PIEDAD,34,64,47,145
16,PUREPERO,2,0,0,2
16,PURUANDIRO,28,11,46,85
16,QUERENDARO,4,7,4,15
16,QUIROGA,31,124,143,298
16,COJUMATLAN DE REGULES,2,0,0,2
16,LOS REYES,41,197,215,453
16,SAHUAYO,1,2,3,6
16,SAN LUCAS,0,1,1,2
16,SANTA ANA MAYA,0,3,18,21
16,SALVADOR ESCALANTE,5,24,24,53
16,SUSUPUATO,0,0,1,1
16,TACAMBARO,6,63,26,95
16,TANCITARO,4,34,36,74
16,TANGAMANDAPIO,5,73,30,108
16,TANGANCICUARO,6,67,19,92
16,TANHUATO,1,14,75,90
16,TARETAN,3,2,1,6
16,TARIMBARO,4,1,1,6
16,TEPALCATEPEC,3,10,3,16
16,TINGAMBATO,6,14,11,31
16,TINGüINDIN,1,23,39,63
16,TIQUICHEO DE NICOLAS ROMERO,3,1,1,5
16,TLALPUJAHUA,0,1,0,1
16,TOCUMBO,3,30,18,51
16,TUMBISCATIO,2,1,1,4
16,TURICATO,0,1,1,2
16,TUXPAN,1,1,0,2
16,TUZANTLA,1,1,0,2
16,TZINTZUNTZAN,4,35,22,61
16,TZITZIO,1,0,1,2
16,URUAPAN,20,122,134,276
16,VENUSTIANO CARRANZA,4,24,73,101
16,VILLAMAR,2,7,6,15
16,VISTA HERMOSA,32,84,85,201
16,YURECUARO,5,57,215,277
16,ZACAPU,6,60,32,98
16,ZAMORA,11,103,138,252
16,MUGICA,1,3,4,8
16,ZINAPARO,2,1,0,3
16,ZINAPECUARO,11,64,5,80
16,ZIRACUARETIRO,0,0,1,1
16,ZITACUARO,3,5,2,10
17,AMACUZAC,2,2,1,5
17,ATLATLAHUCAN,2,4,11,17
17,AXOCHIAPAN,9,3,0,12
17,AYALA,17,6,1,24
17,COATLAN DEL RIO,1,1,0,2
17,CUAUTLA,101,84,32,217
17,CUERNAVACA,11,4,5,20
17,EMILIANO ZAPATA,2,1,0,3
17,JANTETELCO,0,14,0,14
17,JIUTEPEC,8,1,0,9
17,JOJUTLA,14,2,0,16
17,JONACATEPEC,5,0,0,5
17,MAZATEPEC,1,1,1,3
17,MIACATLAN,2,0,3,5
17,OCUITUCO,1,1,0,2
17,PUENTE DE IXTLA,8,10,0,18
17,TEMIXCO,4,0,1,5
17,TEMOAC,17,0,0,17
17,TEPALCINGO,5,1,0,6
17,TETECALA,1,0,0,1
17,TLALNEPANTLA,3,4,0,7
17,TLALTIZAPAN,9,8,0,17
17,TLAQUILTENANGO,4,0,2,6
17,TLAYACAPAN,1,2,0,3
17,TOTOLAPAN,1,0,0,1
17,YAUTEPEC,12,1,0,13
17,YECAPIXTLA,9,27,0,36
17,ZACATEPEC,31,24,25,80
18,ACAPONETA,3,21,23,47
18,AHUACATLAN,1,9,15,25
18,AMATLAN DE CAÑAS,11,52,30,93
18,COMPOSTELA,24,25,3,52
18,HUAJICORI,0,1,0,1
18,IXTLAN DEL RIO,6,36,88,130
18,JALA,8,19,36,63
18,XALISCO,0,9,1,10
18,ROSAMORADA,27,17,1,45
18,RUIZ,9,1,7,17
18,SAN BLAS,14,22,19,55
18,SAN PEDRO LAGUNILLAS,1,0,0,1
18,SANTA MARIA DEL ORO,8,9,5,22
18,SANTIAGO IXCUINTLA,37,66,32,135
18,TECUALA,13,9,7,29
18,TEPIC,5336,1622,269,7227
18,TUXPAN,13,6,0,19
18,BAHIA DE BANDERAS,23,8,3,34
19,AGUALEGUAS,0,0,8,8
19,ALLENDE,2,24,0,26
19,ANAHUAC,0,0,2,2
19,APODACA,1,0,4,5
19,ARAMBERRI,10,6,0,16
19,BUSTAMANTE,2,1,0,3
19,CADEREYTA JIMENEZ,0,3,42,45
19,CARMEN,1,2,0,3
19,CERRALVO,0,0,4,4
19,CHINA,30,9,6,45
19,CIENEGA DE FLORES,5,13,2,20
19,DR. ARROYO,2,1,0,3
19,DR. GONZALEZ,0,2,0,2
19,GALEANA,3,11,25,39
19,GARCIA,25,43,6,74
19,SAN PEDRO GARZA GARCIA,0,0,2,2
19,GRAL. BRAVO,0,1,2,3
19,GRAL. ESCOBEDO,0,0,8,8
19,GRAL. TERAN,7,4,22,33
19,GRAL. ZUAZUA,13,34,0,47
19,GUADALUPE,0,0,6,6
19,HIDALGO,5,9,0,14
19,HIGUERAS,0,0,7,7
19,JUAREZ,2,0,0,2
19,LINARES,4,9,28,41
19,MINA,1,1,1,3
19,MONTEMORELOS,29,69,72,170
19,MONTERREY,2,0,5,7
19,PARAS,0,0,2,2
19,PESQUERIA,1,3,2,6
19,LOS RAMONES,0,1,0,1
19,RAYONES,0,2,0,2
19,SABINAS HIDALGO,8,25,16,49
19,SALINAS VICTORIA,2,21,11,34
19,SAN NICOLAS DE LOS GARZA,0,0,36,36
19,SANTA CATARINA,0,0,25,25
19,SANTIAGO,9,17,4,30
19,VALLECILLO,0,0,6,6
20,ACATLAN DE PEREZ FIGUEROA,310,138,12,460
20,ASUNCION CUYOTEPEJI,1,0,0,1
20,ASUNCION IXTALTEPEC,1,0,1,2
20,ASUNCION NOCHIXTLAN,3,2,0,5
20,ASUNCION TLACOLULITA,0,1,1,2
20,CALIHUALA,1,0,0,1
20,CANDELARIA LOXICHA,6,0,0,6
20,CHAHUITES,1,10,16,27
20,CIUDAD IXTEPEC,1,0,0,1
20,COSOLAPA,0,1,0,1
20,HEROICA CIUDAD DE EJUTLA DE CRESPO,4,5,6,15
20,GUADALUPE ETLA,0,1,0,1
20,VILLA HIDALGO,0,0,2,2
20,HEROICA CIUDAD DE HUAJUAPAN DE LEON,1,6,8,15
20,IXTLAN DE JUAREZ,5,0,0,5
20,HEROICA CIUDAD DE JUCHITAN DE ZARAGOZA,2,2,2,6
20,LOMA BONITA,0,1,4,5
20,MAGDALENA APASCO,0,0,1,1
20,MAGDALENA JALTEPEC,1,0,0,1
20,MAGDALENA TEQUISISTLAN,1,0,0,1
20,MIAHUATLAN DE PORFIRIO DIAZ,1,0,6,7
20,NAZARENO ETLA,0,1,0,1
20,SANTIAGO NILTEPEC,2,0,3,5
20,OAXACA DE JUAREZ,7,4,5,16
20,OCOTLAN DE MORELOS,2,0,0,2
20,PLUMA HIDALGO,4,0,0,4
20,SAN JOSE DEL PROGRESO,1,0,0,1
20,PUTLA VILLA DE GUERRERO,3,0,0,3
20,REFORMA DE PINEDA,1,0,0,1
20,LA REFORMA,1,0,1,2
20,REYES ETLA,0,1,0,1
20,SALINA CRUZ,0,0,1,1
20,SAN AGUSTIN ETLA,1,0,0,1
20,SAN AGUSTIN LOXICHA,2,0,0,2
20,SAN ANDRES HUAXPALTEPEC,5,0,0,5
20,SAN ANDRES SINAXTLA,0,0,1,1
20,SAN ANTONIO DE LA CAL,0,3,0,3
20,SAN BARTOLOME LOXICHA,1,0,0,1
20,SAN BLAS ATEMPA,0,0,1,1
20,SAN DIONISIO OCOTEPEC,2,0,0,2
20,SAN FRANCISCO CHINDUA,0,0,1,1
20,SAN FRANCISCO DEL MAR,1,0,0,1
20,SAN FRANCISCO IXHUATAN,0,1,1,2
20,SAN FRANCISCO LACHIGOLO,0,1,5,6
20,SAN JACINTO AMILPAS,2,0,0,2
20,SAN JERONIMO SOSOLA,0,0,1,1
20,ANIMAS TRUJANO,0,0,1,1
20,SAN JUAN BAUTISTA LO DE SOTO,0,0,1,1
20,SAN JUAN BAUTISTA TUXTEPEC,29,20,20,69
20,SAN JUAN BAUTISTA VALLE NACIONAL,0,1,0,1
20,SAN JUAN COTZOCON,0,1,1,2
20,SAN JUAN GUICHICOVI,1,0,0,1
20,SAN JUAN LACHIGALLA,0,1,0,1
20,SAN JUAN MAZATLAN,0,0,1,1
20,SAN JUAN MIXTEPEC -DTO. 08 -,0,1,0,1
20,SAN LORENZO CACAOTEPEC,0,2,0,2
20,SAN MATEO ETLATONGO,0,1,0,1
20,SAN MIGUEL ALOAPAM,2,0,0,2
20,SAN MIGUEL EL GRANDE,0,3,0,3
20,SAN MIGUEL QUETZALTEPEC,6,0,0,6
20,SAN MIGUEL SOYALTEPEC,32,17,1,50
20,SAN PABLO ETLA,6,0,19,25
20,SAN PABLO HUIXTEPEC,0,0,3,3
20,SAN PABLO VILLA DE MITLA,0,0,1,1
20,SAN PEDRO APOSTOL,0,0,1,1
20,SAN PEDRO MIXTEPEC -DTO. 22 -,7,7,0,14
20,SAN PEDRO POCHUTLA,8,2,0,10
20,SAN PEDRO TAPANATEPEC,7,23,24,54
20,VILLA DE TUTUTEPEC DE MELCHOR OCAMPO,1,9,5,15
20,VILLA DE ETLA,1,2,1,4
20,SAN PEDRO Y SAN PABLO TEPOSCOLULA,0,0,1,1
20,SAN PEDRO YOLOX,1,0,0,1
20,SAN SEBASTIAN IXCAPA,0,0,2,2
20,SANTA ANA ZEGACHE,0,0,1,1
20,SANTA CATARINA JUQUILA,6,0,0,6
20,SANTA CATARINA LOXICHA,1,0,0,1
20,SANTA CATARINA MECHOACAN,0,0,1,1
20,SANTA CATARINA MINAS,0,1,0,1
20,SANTA CRUZ ITUNDUJIA,5,0,0,5
20,SANTA CRUZ PAPALUTLA,0,0,1,1
20,SANTA CRUZ XOXOCOTLAN,2,0,0,2
20,SANTA GERTRUDIS,1,0,0,1
20,SANTA LUCIA DEL CAMINO,0,0,2,2
20,HEROICA CIUDAD DE TLAXIACO,1,0,1,2
20,SANTA MARIA ATZOMPA,1,0,5,6
20,SANTA MARIA CHACHOAPAM,0,1,0,1
20,SANTA MARIA CHILCHOTLA,1,0,0,1
20,SANTA MARIA COLOTEPEC,0,1,1,2
20,SANTA MARIA COYOTEPEC,0,1,0,1
20,SANTA MARIA GUIENAGATI,4,0,0,4
20,SANTA MARIA HUATULCO,1,6,3,10
20,SANTA MARIA JALAPA DEL MARQUES,1,0,0,1
20,SANTA MARIA PETAPA,0,0,1,1
20,SANTA MARIA TONAMECA,0,11,2,13
20,SANTA MARIA TOTOLAPILLA,5,1,0,6
20,SANTA MARIA YUCUHITI,1,0,0,1
20,SANTA MARIA ZACATEPEC,1,0,0,1
20,SANTIAGO CHAZUMBA,2,0,0,2
20,SANTIAGO JOCOTEPEC,0,0,1,1
20,SANTIAGO MATATLAN,6,1,0,7
20,SANTIAGO MILTEPEC,0,0,1,1
20,SANTIAGO NACALTEPEC,0,0,1,1
20,SANTIAGO PINOTEPA NACIONAL,5,2,1,8
20,SANTIAGO XANICA,4,0,0,4
20,SANTIAGO YAVEO,0,2,0,2
20,NUEVO ZOQUIAPAM,1,2,0,3
20,SANTO DOMINGO INGENIO,2,1,7,10
20,SANTO DOMINGO TEHUANTEPEC,0,0,2,2
20,SANTO DOMINGO YANHUITLAN,1,0,0,1
20,SANTO DOMINGO ZANATEPEC,7,2,2,11
20,SILACAYOAPAM,0,1,0,1
20,SOLEDAD ETLA,0,1,0,1
20,TEOTITLAN DE FLORES MAGON,0,0,1,1
20,TEZOATLAN DE SEGURA Y LUNA,0,1,0,1
20,TLACOLULA DE MATAMOROS,0,1,0,1
20,TLALIXTAC DE CABRERA,0,0,2,2
20,UNION HIDALGO,0,2,5,7
20,VILLA DE ZAACHILA,3,0,0,3
20,ZIMATLAN DE ALVAREZ,14,1,1,16
21,ACAJETE,1,0,0,1
21,ACATENO,3,1,0,4
21,ACATLAN,2,0,0,2
21,ACATZINGO,4,3,0,7
21,ACTEOPAN,13,1,0,14
21,AHUAZOTEPEC,1,1,0,2
21,ALJOJUCA,3,2,2,7
21,ALTEPEXI,1,2,0,3
21,AMOZOC,3,4,1,8
21,AQUIXTLA,22,28,0,50
21,ATEMPAN,1,1,0,2
21,ATLIXCO,0,2,13,15
21,ATZITZINTLA,1,0,0,1
21,ATZITZIHUACAN,11,0,0,11
21,AYOTOXCO DE GUERRERO,8,3,0,11
21,CHALCHICOMULA DE SESMA,4,1,0,5
21,CHIAUTLA,4,2,0,6
21,CHIAUTZINGO,2,1,0,3
21,CHIETLA,24,24,31,79
21,CHIGNAHUAPAN,24,11,3,38
21,CHIGNAUTLA,3,4,0,7
21,CHILA DE LA SAL,2,1,0,3
21,COHUECAN,1,0,0,1
21,CORONANGO,0,0,1,1
21,COXCATLAN,1,1,0,2
21,CUAUTEMPAN,4,0,0,4
21,CUAUTLANCINGO,0,0,2,2
21,CUETZALAN DEL PROGRESO,22,1,0,23
21,CUYOACO,33,13,1,47
21,ESPERANZA,1,0,0,1
21,FRANCISCO Z. MENA,3,1,0,4
21,GENERAL FELIPE ANGELES,1,0,0,1
21,GUADALUPE VICTORIA,1,4,1,6
21,HUAQUECHULA,4,7,2,13
21,HUATLATLAUCA,0,1,0,1
21,HUAUCHINANGO,11,5,0,16
21,HUEHUETLA,1,0,0,1
21,HUEHUETLAN EL CHICO,2,1,0,3
21,HUEJOTZINGO,3,1,4,8
21,HUEYTAMALCO,4,7,2,13
21,HUITZILAN DE SERDAN,0,1,0,1
21,IXCAQUIXTLA,3,0,0,3
21,IXTACAMAXTITLAN,3,4,0,7
21,IZUCAR DE MATAMOROS,0,5,0,5
21,JALPAN,0,1,0,1
21,JONOTLA,1,1,0,2
21,JUAN C. BONILLA,1,0,0,1
21,JUAN GALINDO,1,0,0,1
21,JUAN N. MENDEZ,1,0,0,1
21,LAFRAGUA,1,2,0,3
21,LIBRES,9,8,7,24
21,MIXTLA,0,1,0,1
21,CAÑADA MORELOS,1,0,1,2
21,NAUZONTLA,0,1,0,1
21,NOPALUCAN,11,7,1,19
21,OCOTEPEC,4,2,0,6
21,OLINTLA,2,1,0,3
21,ORIENTAL,10,9,0,19
21,PALMAR DE BRAVO,1,2,2,5
21,PUEBLA,7,8,8,23
21,QUECHOLAC,2,1,0,3
21,RAFAEL LARA GRAJALES,1,4,1,6
21,LOS REYES DE JUAREZ,0,0,6,6
21,SAN ANDRES CHOLULA,3,0,2,5
21,SAN FELIPE TEOTLALCINGO,1,0,0,1
21,SAN GABRIEL CHILAC,0,2,1,3
21,SAN JOSE MIAHUATLAN,0,0,1,1
21,SAN JUAN ATENCO,2,0,3,5
21,SAN MARTIN TEXMELUCAN,0,2,2,4
21,SAN MATIAS TLALANCALECA,2,1,0,3
21,SAN NICOLAS BUENOS AIRES,5,0,1,6
21,SAN PEDRO CHOLULA,0,6,2,8
21,SAN PEDRO YELOIXTLAHUACA,0,1,0,1
21,SAN SALVADOR EL SECO,2,2,1,5
21,SAN SALVADOR HUIXCOLOTLA,0,0,1,1
21,SANTIAGO MIAHUATLAN,0,0,1,1
21,SANTO TOMAS HUEYOTLIPAN,1,0,1,2
21,SOLTEPEC,3,1,0,4
21,TECALI DE HERRERA,2,2,0,4
21,TECAMACHALCO,9,5,36,50
21,TECOMATLAN,1,1,0,2
21,TEHUACAN,3,4,1,8
21,TEHUITZINGO,0,1,0,1
21,TENAMPULCO,1,0,4,5
21,TEOPANTLAN,2,0,0,2
21,TEPANCO DE LOPEZ,3,5,27,35
21,TEPANGO DE RODRIGUEZ,1,0,0,1
21,TEPATLAXCO DE HIDALGO,0,1,0,1
21,TEPEACA,4,0,0,4
21,TEPEXCO,3,1,0,4
21,TEPEXI DE RODRIGUEZ,4,4,0,8
21,TEPEYAHUALCO,20,11,8,39
21,TETELA DE OCAMPO,4,20,0,24
21,TETELES DE AVILA CASTILLO,0,5,0,5
21,TIANGUISMANALCO,1,0,2,3
21,TILAPA,1,0,2,3
21,TLACHICHUCA,45,10,2,57
21,TLACOTEPEC DE BENITO JUAREZ,3,3,1,7
21,TLACUILOTEPEC,0,4,0,4
21,TLAHUAPAN,6,5,1,12
21,TLAOLA,2,0,0,2
21,TLAPANALA,1,5,0,6
21,TLATLAUQUITEPEC,15,12,1,28
21,TLAXCO,3,3,0,6
21,TOCHIMILCO,6,0,1,7
21,TOCHTEPEC,1,0,0,1
21,TULCINGO,1,2,0,3
21,TUZAMAPAN DE GALEANA,2,0,0,2
21,VENUSTIANO CARRANZA,1,5,0,6
21,XICOTEPEC,17,41,5,63
21,XIUTETELCO,3,0,0,3
21,XOCHIAPULCO,1,0,0,1
21,XOCHITLÁN DE VICENTE SUÁREZ,1,1,0,2
21,XOCHITLAN TODOS SANTOS,8,5,1,14
21,YAONAHUAC,0,2,0,2
21,YEHUALTEPEC,0,1,0,1
21,ZACAPOAXTLA,3,7,0,10
21,ZACATLAN,2,7,1,10
21,ZAPOTITLAN DE MENDEZ,0,2,0,2
21,ZARAGOZA,2,1,0,3
21,ZAUTLA,3,5,1,9
21,ZIHUATEUTLA,1,2,5,8
21,ZONGOZOTLA,1,2,0,3
21,ZOQUIAPAN,0,2,0,2
22,AMEALCO DE BONFIL,8,10,7,25
22,PINAL DE AMOLES,4,0,0,4
22,ARROYO SECO,2,1,0,3
22,CADEREYTA DE MONTES,14,11,11,36
22,COLON,15,8,54,77
22,CORREGIDORA,0,2,7,9
22,EZEQUIEL MONTES,5,3,94,102
22,HUIMILPAN,6,6,13,25
22,JALPAN DE SERRA,18,10,0,28
22,LANDA DE MATAMOROS,3,0,0,3
22,EL MARQUES,33,16,59,108
22,PEDRO ESCOBEDO,57,45,81,183
22,PEÑAMILLER,1,0,1,2
22,QUERETARO,1,1,146,148
22,SAN JUAN DEL RIO,15,11,41,67
22,TEQUISQUIAPAN,16,16,7,39
22,TOLIMAN,3,2,3,8
23,BENITO JUAREZ,2,0,26,28
23,JOSE MARIA MORELOS,3,1,0,4
23,FELIPE CARRILLO PUERTO,10,4,3,17
23,ISLA MUJERES,0,0,1,1
23,LAZARO CARDENAS,0,2,0,2
23,OTHON P. BLANCO,245,238,185,668
23,SOLIDARIDAD,0,1,0,1
23,TULUM,1,1,0,2
24,AHUALULCO,1,5,0,6
24,AQUISMON,0,0,1,1
24,CARDENAS,0,2,0,2
24,CIUDAD FERNANDEZ,1,4,1,6
24,CEDRAL,1,1,1,3
24,CERRITOS,10,27,0,37
24,CHARCAS,1,4,0,5
24,CIUDAD VALLES,26,22,40,88
24,CIUDAD DEL MAIZ,0,1,3,4
24,EBANO,36,33,29,98
24,GUADALCAZAR,1,1,1,3
24,VILLA DE GUADALUPE,2,8,6,16
24,MATEHUALA,1,7,1,9
24,MEXQUITIC DE CARMONA,1,8,0,9
24,MOCTEZUMA,1,2,1,4
24,SAN CIRO DE ACOSTA,0,1,0,1
24,VILLA DE RAMOS,10,1,3,14
24,RIOVERDE,6,31,15,52
24,SALINAS,4,11,3,18
24,SAN LUIS POTOSI,7,18,30,55
24,SAN MARTIN CHALCHICUAUTLA,0,3,0,3
24,SANTA MARIA DEL RIO,48,99,0,147
24,SANTO DOMINGO,2,4,2,8
24,SOLEDAD DE GRACIANO SANCHEZ,3,6,0,9
24,TAMASOPO,9,3,3,15
24,TAMAZUNCHALE,4,4,1,9
24,TAMPACAN,0,2,0,2
24,TAMUIN,3,18,41,62
24,SAN VICENTE TANCUAYALAB,0,0,20,20
24,TANLAJAS,0,0,1,1
24,TANQUIAN DE ESCOBEDO,0,3,1,4
24,TIERRA NUEVA,1,1,0,2
24,VENADO,6,11,2,19
24,VANEGAS,1,0,5,6
24,VILLA DE ARRIAGA,3,5,3,11
24,VILLA HIDALGO,10,1,0,11
24,VILLA DE ARISTA,2,10,1,13
24,VILLA DE REYES,7,42,2,51
24,VILLA JUAREZ,0,2,2,4
24,ZARAGOZA,2,0,0,2
24,EL NARANJO,108,80,47,235
25,AHOME,142,275,764,1181
25,ANGOSTURA,35,41,57,133
25,CHOIX,0,0,1,1
25,CULIACAN,259,273,737,1269
25,EL FUERTE,17,61,151,229
25,ELOTA,20,36,18,74
25,ESCUINAPA,7,16,17,40
25,GUASAVE,218,252,339,809
25,MAZATLAN,53,87,75,215
25,MOCORITO,7,12,11,30
25,NAVOLATO,91,76,356,523
25,ROSARIO,41,15,9,65
25,SALVADOR ALVARADO,38,41,144,223
25,SAN IGNACIO,9,5,3,17
25,SINALOA,63,29,61,153
26,ACONCHI,27,9,4,40
26,AGUA PRIETA,13,3,30,46
26,ALAMOS,59,24,0,83
26,ALTAR,2,5,1,8
26,ARIVECHI,29,2,2,33
26,ARIZPE,9,12,8,29
26,ATIL,2,0,3,5
26,BACADEHUACHI,12,17,0,29
26,BACANORA,12,5,0,17
26,BACERAC,1,0,0,1
26,BACOACHI,1,0,0,1
26,BACUM,13,25,27,65
26,BANAMICHI,19,7,1,27
26,BAVIACORA,14,15,3,32
26,BAVISPE,12,7,3,22
26,BENITO JUAREZ,15,19,48,82
26,BENJAMIN HILL,0,2,0,2
26,CABORCA,34,28,79,141
26,CAJEME,105,232,571,908
26,CANANEA,4,1,1,6
26,CARBO,1,13,5,19
26,LA COLORADA,29,26,4,59
26,CUCURPE,6,2,3,11
26,CUMPAS,17,8,13,38
26,DIVISADEROS,37,15,0,52
26,EMPALME,9,18,13,40
26,ETCHOJOA,69,69,57,195
26,FRONTERAS,17,9,1,27
26,GRANADOS,5,3,23,31
26,GUAYMAS,64,38,148,250
26,SAN IGNACIO RIO MUERTO,10,32,31,73
26,HERMOSILLO,44,43,277,364
26,HUACHINERA,1,4,7,12
26,HUASABAS,5,0,0,5
26,HUATABAMPO,38,28,96,162
26,HUEPAC,3,5,1,9
26,IMURIS,1,2,5,8
26,MAGDALENA,28,10,6,44
26,MAZATAN,6,16,0,22
26,MOCTEZUMA,13,12,1,26
26,NACORI CHICO,36,24,3,63
26,NACOZARI DE GARCIA,6,1,0,7
26,NAVOJOA,40,43,96,179
26,NOGALES,3,1,0,4
26,ONAVAS,34,5,0,39
26,OPODEPE,15,16,3,34
26,VILLA HIDALGO,2,3,0,5
26,PITIQUITO,11,10,3,24
26,GENERAL PLUTARCO ELIAS CALLES,0,1,0,1
26,PUERTO PEÑASCO,0,4,9,13
26,QUIRIEGO,7,9,7,23
26,RAYON,5,7,0,12
26,ROSARIO,59,14,3,76
26,SAHUARIPA,103,30,7,140
26,SAN FELIPE DE JESUS,1,0,0,1
26,SAN JAVIER,0,2,0,2
26,SAN LUIS RIO COLORADO,209,144,82,435
26,SAN MIGUEL DE HORCASITAS,14,8,5,27
26,SAN PEDRO DE LA CUEVA,7,3,0,10
26,SANTA ANA,4,9,2,15
26,SANTA CRUZ,11,5,0,16
26,SARIC,1,6,2,9
26,SOYOPA,34,6,1,41
26,SUAQUI GRANDE,10,6,0,16
26,TEPACHE,5,2,0,7
26,TRINCHERAS,10,19,3,32
26,TUBUTAMA,4,1,0,5
26,URES,103,82,15,200
26,VILLA PESQUEIRA,33,26,0,59
26,YECORA,63,30,4,97
27,BALANCAN,8,33,9,50
27,CARDENAS,84,85,93,262
27,CENTLA,4,15,1,20
27,CENTRO,32,108,2,142
27,COMALCALCO,78,66,0,144
27,CUNDUACAN,3,12,0,15
27,EMILIANO ZAPATA,9,15,2,26
27,HUIMANGUILLO,25,31,12,68
27,JALPA DE MENDEZ,1,4,0,5
27,JONUTA,4,7,0,11
27,MACUSPANA,2,7,0,9
27,NACAJUCA,1,1,0,2
27,PARAISO,1,13,0,14
27,TEAPA,2,36,0,38
27,TENOSIQUE,6,3,4,13
27,TACOTALPA,0,2,0,2
28,ABASOLO,22,28,34,84
28,ALDAMA,3,6,80,89
28,ALTAMIRA,4,8,30,42
28,ANTIGUO MORELOS,15,5,14,34
28,BURGOS,0,0,4,4
28,CAMARGO,3,2,8,13
28,CASAS,3,11,11,25
28,CRUILLAS,0,0,2,2
28,GUSTAVO DIAZ ORDAZ,20,4,12,36
28,GOMEZ FARIAS,0,1,5,6
28,GONZALEZ,7,25,95,127
28,GüEMEZ,0,4,20,24
28,HIDALGO,1,1,7,9
28,JAUMAVE,2,0,0,2
28,JIMENEZ,0,2,30,32
28,LLERA,0,3,11,14
28,MAINERO,0,3,1,4
28,EL MANTE,35,37,71,143
28,MATAMOROS,30,35,104,169
28,MENDEZ,100,1,7,108
28,MIER,0,0,1,1
28,MIGUEL ALEMAN,0,0,7,7
28,NUEVO MORELOS,10,3,7,20
28,OCAMPO,78,54,30,162
28,PADILLA,5,11,5,21
28,REYNOSA,68,13,68,149
28,RIO BRAVO,128,81,168,377
28,SAN CARLOS,1,6,6,13
28,SAN FERNANDO,70,38,167,275
28,SAN NICOLAS,0,1,0,1
28,SOTO LA MARINA,8,11,55,74
28,TAMPICO,0,0,1,1
28,TULA,1,0,3,4
28,VALLE HERMOSO,86,75,138,299
28,VICTORIA,1,2,16,19
28,XICOTENCATL,14,19,22,55
29,APETATITLAN DE ANTONIO CARVAJAL,0,0,3,3
29,ATLANGATEPEC,6,4,0,10
29,ALTZAYANCA,5,8,0,13
29,APIZACO,2,1,0,3
29,CALPULALPAN,34,32,0,66
29,EL CARMEN TEQUEXQUITLA,0,2,0,2
29,CHIAUTEMPAN,0,1,0,1
29,CUAPIAXTLA,14,8,1,23
29,CUAXOMULCO,2,0,0,2
29,MUÑOZ DE DOMINGO ARENAS,11,1,2,14
29,ESPAÑITA,1,1,1,3
29,HUAMANTLA,4,6,7,17
29,HUEYOTLIPAN,16,2,3,21
29,IXTACUIXTLA DE MARIANO MATAMOROS,7,5,3,15
29,IXTENCO,1,1,0,2
29,LAZARO CARDENAS,7,3,0,10
29,NANACAMILPA DE MARIANO ARISTA,16,4,0,20
29,TOCATLAN,5,0,1,6
29,TEPEYANCO,1,5,0,6
29,TERRENATE,4,10,0,14
29,TETLA DE LA SOLIDARIDAD,2,0,1,3
29,TETLATLAHUCA,0,1,3,4
29,TLAXCALA,2,1,0,3
29,TLAXCO,17,15,2,34
29,TZOMPANTEPEC,7,1,0,8
29,XALOZTOC,3,2,1,6
29,XALTOCAN,2,3,0,5
29,PAPALOTLA DE XICOHTENCATL,0,1,0,1
29,YAUHQUEMECAN,0,1,0,1
29,BENITO JUAREZ,7,2,0,9
29,SAN JERONIMO ZACUALPAN,0,1,0,1
29,SAN JOSE TEACALCO,7,1,0,8
29,SAN LUCAS TECOPILCO,1,1,0,2
29,SANCTORUM DE LAZARO CARDENAS,3,1,1,5
29,SANTA ANA NOPALUCAN,1,0,0,1
30,ACATLAN,0,1,0,1
30,ACAYUCAN,2,12,6,20
30,ACTOPAN,10,4,0,14
30,ACULA,0,0,1,1
30,CAMARON DE TEJEDA,6,3,0,9
30,ALTO LUCERO DE GUTIERREZ BARRIOS,0,0,1,1
30,ALTOTONGA,0,0,2,2
30,ALVARADO,0,0,4,4
30,AMATITLAN,1,0,0,1
30,AMATLAN DE LOS REYES,0,0,3,3
30,ANGEL R. CABADA,0,0,1,1
30,LA ANTIGUA,24,15,21,60
30,ATOYAC,22,25,16,63
30,ATZALAN,8,4,3,15
30,BOCA DEL RIO,1,0,0,1
30,CATEMACO,2,0,3,5
30,CAZONES DE HERRERA,2,0,1,3
30,CHACALTIANGUIS,0,0,1,1
30,CHALMA,1,1,0,2
30,CHICONTEPEC,2,0,0,2
30,CHINAMECA,1,0,0,1
30,LAS CHOAPAS,5,19,0,24
30,CHOCAMAN,1,0,1,2
30,COATEPEC,3,0,0,3
30,COATZINTLA,0,1,0,1
30,COSAUTLAN DE CARVAJAL,3,1,0,4
30,COMAPA,1,0,0,1
30,CORDOBA,12,5,14,31
30,COSAMALOAPAN DE CARPIO,7,5,20,32
30,COSCOMATEPEC,0,2,34,36
30,COTAXTLA,3,1,5,9
30,COYUTLA,5,1,0,6
30,CUICHAPA,4,6,7,17
30,CUITLAHUAC,1,2,0,3
30,EMILIANO ZAPATA,4,1,2,7
30,ESPINAL,1,2,0,3
30,FORTIN,1,4,5,10
30,GUTIERREZ ZAMORA,1,3,3,7
30,HIDALGOTITLAN,0,0,2,2
30,HUATUSCO,4,0,28,32
30,HUEYAPAN DE OCAMPO,7,5,5,17
30,ISLA,21,75,43,139
30,IXHUATLAN DEL SURESTE,0,0,1,1
30,IXHUATLAN DE MADERO,1,0,0,1
30,IXTACZOQUITLAN,0,1,6,7
30,JALACINGO,1,0,0,1
30,XALAPA,0,4,2,6
30,JALTIPAN,0,6,1,7
30,JESUS CARRANZA,0,3,14,17
30,XICO,0,0,4,4
30,JILOTEPEC,1,0,0,1
30,JUAN RODRIGUEZ CLARA,0,1,5,6
30,JUCHIQUE DE FERRER,0,1,0,1
30,LERDO DE TEJADA,6,0,2,8
30,MANLIO FABIO ALTAMIRANO,2,1,0,3
30,MARTINEZ DE LA TORRE,12,8,6,26
30,MEDELLIN,2,2,0,4
30,MINATITLAN,0,2,4,6
30,MISANTLA,3,0,0,3
30,NAOLINCO,2,1,1,4
30,NAUTLA,1,0,0,1
30,OLUTA,0,1,1,2
30,OMEALCA,19,17,2,38
30,OZULUAMA DE MASCAREÑAS,3,2,13,18
30,PANUCO,154,113,90,357
30,PAPANTLA,13,3,7,23
30,PASO DE OVEJAS,4,0,0,4
30,PASO DEL MACHO,233,50,15,298
30,PEROTE,0,6,9,15
30,PLATON SANCHEZ,0,0,12,12
30,PLAYA VICENTE,3,1,2,6
30,PUEBLO VIEJO,0,0,1,1
30,PUENTE NACIONAL,3,1,1,5
30,SALTABARRANCA,2,0,0,2
30,SAN ANDRES TUXTLA,0,0,1,1
30,SAN JUAN EVANGELISTA,0,0,7,7
30,SANTIAGO TUXTLA,1,0,0,1
30,SAYULA DE ALEMAN,2,1,8,11
30,SOCHIAPA,7,0,0,7
30,SOCONUSCO,0,0,1,1
30,SOLEDAD DE DOBLADO,1,3,0,4
30,SOTEAPAN,1,0,0,1
30,TAMALIN,0,0,1,1
30,TAMIAHUA,5,0,0,5
30,TAMPICO ALTO,0,2,4,6
30,TANTIMA,0,0,1,1
30,TANTOYUCA,0,1,21,22
30,CASTILLO DE TEAYO,5,0,0,5
30,TECOLUTLA,2,1,1,4
30,ALAMO TEMAPACHE,4,0,3,7
30,TEMPOAL,2,0,6,8
30,TEOCELO,0,0,7,7
30,TEPETLAN,2,0,0,2
30,TEPETZINTLA,0,0,1,1
30,JOSE AZUETA,0,1,1,2
30,TEXISTEPEC,1,2,1,4
30,TEZONAPA,173,171,90,434
30,TIERRA BLANCA,33,33,27,93
30,TIHUATLAN,2,1,0,3
30,TLACOJALPAN,0,0,1,1
30,TLACOTALPAN,0,1,0,1
30,TRES VALLES,17,18,21,56
30,TLACOTEPEC DE MEJIA,1,0,0,1
30,TLALIXCOYAN,4,16,5,25
30,TLAPACOYAN,6,0,7,13
30,TUXPAN,3,0,0,3
30,URSULO GALVAN,206,32,9,247
30,VEGA DE ALATORRE,0,11,4,15
30,VERACRUZ,2,3,4,9
30,LAS VIGAS DE RAMIREZ,0,4,0,4
30,VILLA ALDAMA,0,1,0,1
30,UXPANAPA,0,0,1,1
30,ZENTLA,4,3,0,7
30,ZONGOLICA,0,0,3,3
30,EL HIGO,4,8,5,17
30,CARLOS A. CARRILLO,7,5,4,16
30,SAN RAFAEL,5,7,3,15
31,ABALA,4,0,0,4
31,ACANCEH,1,0,0,1
31,CACALCHEN,2,0,0,2
31,CHAPAB,0,3,0,3
31,CHICXULUB PUEBLO,0,0,2,2
31,DZILAM DE BRAVO,0,0,1,1
31,HOCTUN,0,1,1,2
31,HUNUCMA,1,1,0,2
31,IZAMAL,10,11,0,21
31,KANASIN,0,1,16,17
31,MERIDA,5,44,86,135
31,MOTUL,5,0,0,5
31,MUNA,0,0,4,4
31,MUXUPIP,1,0,0,1
31,OXKUTZCAB,0,0,3,3
31,PROGRESO,11,23,42,76
31,SEYE,0,0,1,1
31,SUDZAL,1,0,0,1
31,TAHMEK,1,0,0,1
31,TEKANTO,2,0,0,2
31,TEKAX,17,3,0,20
31,TECOH,1,0,0,1
31,TEMOZON,0,1,0,1
31,TEPAKAN,1,0,0,1
31,TEYA,0,0,12,12
31,TICUL,211,21,0,232
31,TIXKOKOB,1,0,0,1
31,TIXPEHUAL,0,1,0,1
31,TIZIMIN,110,7,17,134
31,TZUCACAB,0,2,0,2
31,UMAN,123,0,0,123
31,VALLADOLID,129,4,8,141
32,APOZOL,4,0,1,5
32,ATOLINGA,0,0,9,9
32,BENITO JUAREZ,7,4,2,13
32,CALERA,0,9,23,32
32,CAÑITAS DE FELIPE PESCADOR,2,2,1,5
32,CONCEPCION DEL ORO,1,0,3,4
32,CUAUHTEMOC,0,0,3,3
32,FRESNILLO,44,24,60,128
32,TRINIDAD GARCIA DE LA CADENA,1,1,0,2
32,GENERAL ENRIQUE ESTRADA,0,3,2,5
32,GENERAL FRANCISCO R. MURGUIA,2,1,5,8
32,GENERAL PANFILO NATERA,1,1,14,16
32,GUADALUPE,3,2,8,13
32,HUANUSCO,1,0,0,1
32,JALPA,8,3,3,14
32,JEREZ,10,0,0,10
32,JUAN ALDAMA,2,3,8,13
32,JUCHIPILA,0,1,0,1
32,LORETO,3,4,18,25
32,LUIS MOYA,13,32,23,68
32,MAZAPIL,0,1,0,1
32,MIGUEL AUZA,15,26,20,61
32,MOMAX,0,1,1,2
32,MONTE ESCOBEDO,12,0,4,16
32,MORELOS,3,4,3,10
32,NORIA DE ANGELES,6,0,1,7
32,OJOCALIENTE,5,6,6,17
32,PANUCO,7,2,15,24
32,PINOS,10,3,4,17
32,RIO GRANDE,30,9,42,81
32,SAIN ALTO,3,1,2,6
32,SOMBRERETE,9,44,40,93
32,TABASCO,0,0,3,3
32,TEPECHITLAN,2,5,8,15
32,TEUL DE GONZALEZ ORTEGA,0,1,0,1
32,TLALTENANGO DE SANCHEZ ROMAN,5,27,30,62
32,VALPARAISO,0,2,1,3
32,VETAGRANDE,0,1,0,1
32,VILLA DE COS,13,9,41,63
32,VILLA GARCIA,1,0,0,1
32,VILLA HIDALGO,11,0,3,14
32,VILLANUEVA,1,0,17,18
32,TRANCOSO,0,1,0,1
32,ZACATECAS,0,3,2,5
