cve_edo,Municipio,PD1,PD2,PD3,Total
1,AGUASCALIENTES,12,11,77,100
1,ASIENTOS,1,4,3,8
1,CALVILLO,4,3,5,12
1,COSIO,2,2,6,10
1,JESUS MARIA,1,10,5,16
1,PABELLON DE ARTEAGA,5,161,55,221
1,RINCON DE ROMOS,2,11,3,16
1,SAN JOSE DE GRACIA,0,2,2,4
1,TEPEZALA,1,0,3,4
1,EL LLANO,0,1,2,3
1,SAN FRANCISCO DE LOS ROMO,3,5,13,21
2,ENSENADA,12,36,85,133
2,MEXICALI,525,408,660,1593
2,TECATE,0,3,1,4
2,TIJUANA,0,0,6,6
2,PLAYAS DE ROSARITO,0,0,1,1
3,LOS CABOS,8,27,44,79
3,COMONDU,23,64,38,125
3,MULEGE,16,9,11,36
3,LA PAZ,11,22,39,72
3,LORETO,1,9,7,17
4,CALKINI,111,14,6,131
4,CAMPECHE,36,37,63,136
4,CARMEN,26,13,22,61
4,CHAMPOTON,24,16,52,92
4,ESCARCEGA,37,59,4,100
4,HECELCHAKAN,16,18,7,41
4,CANDELARIA,34,8,3,45
4,HOPELCHEN,49,112,76,237
4,PALIZADA,2,25,36,63
4,CALAKMUL,3,2,0,5
4,TENABO,17,4,0,21
7,ACALA,20,29,1,50
7,ACAPETAHUA,1,0,3,4
7,ARRIAGA,34,63,3,100
7,BELLA VISTA,1,0,0,1
7,BERRIOZABAL,1,10,0,11
7,BOCHIL,6,3,0,9
7,EL BOSQUE,5,0,0,5
7,CACAHOATAN,0,1,1,2
7,CATAZAJA,1,2,1,4
7,CHAPULTENANGO,1,0,0,1
7,CHENALHO,5,0,0,5
7,CHIAPA DE CORZO,243,174,5,422
7,CHIAPILLA,0,3,0,3
7,CHICOASEN,0,2,0,2
7,CHICOMUSELO,1,1,0,2
7,CHILON,3,0,0,3
7,CINTALAPA,96,41,9,146
7,COAPILLA,1,0,0,1
7,COMITAN DE DOMINGUEZ,104,40,5,149
7,LA CONCORDIA,62,45,17,124
7,COPAINALA,0,2,0,2
7,ESCUINTLA,7,1,1,9
7,FRANCISCO LEON,1,0,0,1
7,FRONTERA COMALAPA,39,22,6,67
7,HUEHUETAN,0,1,2,3
7,HUIXTLA,95,25,4,124
7,LA INDEPENDENCIA,2,0,0,2
7,IXTAPA,17,8,0,25
7,JIQUIPILAS,21,6,5,32
7,JITOTOL,8,0,0,8
7,JUAREZ,2,7,10,19
7,LARRAINZAR,1,0,0,1
7,LA LIBERTAD,0,1,0,1
7,MAPASTEPEC,108,37,4,149
7,LAS MARGARITAS,6,1,0,7
7,MAZATAN,5,1,5,11
7,MOTOZINTLA,9,0,1,10
7,OCOSINGO,48,3,0,51
7,OCOZOCOAUTLA DE ESPINOSA,25,10,1,36
7,OXCHUC,1,0,0,1
7,PALENQUE,16,18,2,36
7,PICHUCALCO,4,3,0,7
7,PIJIJIAPAN,26,18,1,45
7,VILLA COMALTITLAN,1,0,5,6
7,PUEBLO NUEVO SOLISTAHUACAN,6,4,0,10
7,RAYON,0,2,0,2
7,REFORMA,0,5,1,6
7,LAS ROSAS,1,0,0,1
7,SALTO DE AGUA,0,2,0,2
7,SAN CRISTOBAL DE LAS CASAS,4,0,1,5
7,SAN FERNANDO,7,9,0,16
7,SILTEPEC,10,0,0,10
7,SIMOJOVEL,21,4,0,25
7,SOCOLTENANGO,12,3,1,16
7,SOYALO,2,5,0,7
7,SUCHIAPA,10,14,1,25
7,SUCHIATE,1,3,2,6
7,TAPACHULA,26,4,56,86
7,TAPILULA,2,2,0,4
7,TECPATAN,7,4,0,11
7,TEOPISCA,1,1,0,2
7,TILA,1,3,0,4
7,TONALA,201,197,22,420
7,TOTOLAPA,9,10,0,19
7,LA TRINITARIA,2,1,1,4
7,TUXTLA GUTIERREZ,78,86,34,198
7,TUXTLA CHICO,0,1,0,1
7,TZIMOL,1,1,0,2
7,VENUSTIANO CARRANZA,43,33,1,77
7,ANGEL ALBINO CORZO,27,25,2,54
7,VILLAFLORES,391,298,23,712
7,YAJALON,2,9,0,11
7,SAN LUCAS,2,1,0,3
7,BENEMERITO DE LAS AMERICAS,3,0,2,5
7,MARQUES DE COMILLAS,7,1,0,8
7,VILLA CORZO,97,94,3,194
8, ALDAMA,1,0,12,13
8, ALLENDE,0,1,4,5
8, ASCENSION,12,8,4,24
8, BACHINIVA,0,0,2,2
8, BALLEZA,5,2,2,9
8, BATOPILAS,2,0,0,2
8, BUENAVENTURA,2,63,87,152
8, CAMARGO,6,4,46,56
8, CARICHI,1,0,1,2
8, CASAS GRANDES,0,0,10,10
8, CHIHUAHUA,16,1,86,103
8, COYAME DEL SOTOL,1,1,2,4
8, LA CRUZ,4,0,4,8
8, CUAUHTEMOC,13,152,204,369
8, CUSIHUIRIACHI,0,0,4,4
8, DELICIAS,5,21,113,139
8, GALEANA,1,2,2,5
8, GOMEZ FARIAS,0,0,1,1
8, GUACHOCHI,14,12,7,33
8, GUADALUPE,0,0,1,1
8, GUADALUPE Y CALVO,9,2,4,15
8, GUAZAPARES,2,0,0,2
8, GUERRERO,4,2,9,15
8, HIDALGO DEL PARRAL,0,2,35,37
8, JANOS,2,2,9,13
8, JIMENEZ,0,13,25,38
8, JUAREZ,1,1,54,56
8, JULIMES,3,4,7,14
8, MADERA,1,1,3,5
8, MANUEL BENAVIDES,0,0,1,1
8, MEOQUI,5,16,34,55
8, NAMIQUIPA,2,17,47,66
8, NUEVO CASAS GRANDES,1,4,7,12
8, OJINAGA,0,10,56,66
8, PRAXEDIS G. GUERRERO,0,1,1,2
8, RIVA PALACIO,0,1,4,5
8, ROSALES,3,4,7,14
8, ROSARIO,0,1,0,1
8, SAN FRANCISCO DE BORJA,0,0,1,1
8, SAN FRANCISCO DE CONCHOS,1,2,13,16
8, SANTA BARBARA,1,1,0,2
8, SATEVO,0,1,7,8
8, SAUCILLO,3,5,24,32
8, EL TULE,0,2,3,5
8, URUACHI,2,0,0,2
8, AHUMADA,1,9,76,86
8, CORONADO,0,5,8,13
8, LOPEZ,1,1,15,17
8, MATAMOROS,1,0,2,3
8, VALLE DE ZARAGOZA,0,0,7,7
5, ACUÑA,0,1,1,2
5, ARTEAGA,1,1,11,13
5, CUATRO CIENEGAS,0,4,6,10
5, FRANCISCO I. MADERO,2,17,29,48
5, GENERAL CEPEDA,2,6,3,11
5, HIDALGO,0,4,0,4
5, JIMENEZ,2,0,0,2
5, LAMADRID,0,1,0,1
5, MATAMOROS,11,23,36,70
5, MONCLOVA,0,0,2,2
5, MUZQUIZ,0,1,1,2
5, NADADORES,0,1,0,1
5, NAVA,0,1,1,2
5, OCAMPO,0,4,1,5
5, PARRAS,18,2,4,24
5, RAMOS ARIZPE,1,2,11,14
5, SABINAS,0,8,2,10
5, SALTILLO,7,15,70,92
5, SAN BUENAVENTURA,0,1,4,5
5, SAN JUAN DE SABINAS,0,4,1,5
5, SAN PEDRO,9,27,40,76
5, TORREON,10,12,161,183
5, VIESCA,1,8,7,16
5, FRONTERA,0,0,3,3
6, ARMERIA,14,5,1,20
6, COLIMA,35,48,116,199
6, COMALA,6,7,0,13
6, COQUIMATLAN,10,7,0,17
6, CUAUHTEMOC,116,76,38,230
6, IXTLAHUACAN,3,0,0,3
6, MANZANILLO,9,4,15,28
6, MINATITLAN,1,2,1,4
6, TECOMAN,15,20,56,91
6, VILLA DE ALVAREZ,3,7,11,21
9, AZCAPOTZALCO,0,0,21,21
9, MIGUEL HIDALGO,0,0,40,40
9, COYOACAN,0,0,10,10
9, CUAJIMALPA DE MORELOS,0,0,24,24
9, GUSTAVO A. MADERO,0,5,6,11
9, IZTAPALAPA,1,0,113,114
9, CUAUHTEMOC,0,0,7,7
9, MILPA ALTA,0,5,0,5
9, ALVARO OBREGON,0,0,73,73
9, BENITO JUAREZ,0,0,65,65
9, TLALPAN,0,1,16,17
9, XOCHIMILCO,1,0,0,1
10, CANATLAN,0,11,5,16
10, CANELAS,2,0,3,5
10, CONETO DE COMONFORT,0,1,0,1
10, CUENCAME,4,15,14,33
10, DURANGO,30,54,131,215
10, GENERAL SIMON BOLIVAR,1,4,2,7
10, GOMEZ PALACIO,7,21,120,148
10, GUADALUPE VICTORIA,14,104,36,154
10, GUANACEVI,9,7,1,17
10, HIDALGO,0,3,3,6
10, INDE,0,3,4,7
10, LERDO,18,8,40,66
10, MAPIMI,4,8,19,31
10, MEZQUITAL,0,2,0,2
10, NAZAS,3,2,7,12
10, NOMBRE DE DIOS,1,11,7,19
10, OCAMPO,4,4,5,13
10, EL ORO,2,1,1,4
10, OTAEZ,4,0,0,4
10, PANUCO DE CORONADO,3,6,6,15
10, PEÑON BLANCO,1,13,2,16
10, POANAS,7,11,4,22
10, PUEBLO NUEVO,1,0,0,1
10, RODEO,0,1,7,8
10, SAN DIMAS,19,3,0,22
10, SAN JUAN DE GUADALUPE,1,0,0,1
10, SAN JUAN DEL RIO,0,1,4,5
10, SAN PEDRO DEL GALLO,1,1,2,4
10, SANTA CLARA,1,0,1,2
10, SANTIAGO PAPASQUIARO,43,3,22,68
10, SUCHIL,0,2,1,3
10, TAMAZULA,4,1,0,5
10, TEPEHUANES,1,8,7,16
10, TLAHUALILO,0,5,13,18
10, TOPIA,1,0,0,1
10, NUEVO IDEAL,5,6,4,15
10, VICENTE GUERRERO,12,6,3,21
11, ABASOLO,40,52,55,147
11, ACAMBARO,12,46,36,94
11, SAN MIGUEL DE ALLENDE,0,15,5,20
11, APASEO EL ALTO,23,10,2,35
11, APASEO EL GRANDE,5,7,8,20
11, MANUEL DOBLADO,27,22,11,60
11, CELAYA,28,117,174,319
11, COMONFORT,8,13,6,27
11, CORONEO,5,1,0,6
11, CORTAZAR,8,10,37,55
11, CUERAMARO,2,1,3,6
11, DOLORES HIDALGO,7,7,22,36
11, DOCTOR MORA,0,0,1,1
11, GUANAJUATO,0,3,1,4
11, HUANIMARO,31,21,4,56
11, IRAPUATO,31,57,258,346
11, JARAL DEL PROGRESO,16,22,26,64
11, JERECUARO,0,0,2,2
11, LEON,33,9,165,207
11, MOROLEON,1,0,9,10
11, OCAMPO,5,7,1,13
11, PENJAMO,58,238,218,514
11, PUEBLO NUEVO,3,16,15,34
11, PURISIMA DEL RINCON,13,20,222,255
11, ROMITA,21,16,11,48
11, SAN DIEGO DE LA UNION,0,0,1,1
11, SAN FRANCISCO DEL RINCON,12,4,10,26
11, SAN JOSE ITURBIDE,6,1,5,12
11, SAN LUIS DE LA PAZ,0,8,23,31
11, SALAMANCA,26,49,140,215
11,SALVATIERRA,21,76,123,220
11,SAN FELIPE,11,14,11,36
11,SANTIAGO MARAVATIO,0,0,13,13
11,SILAO,7,15,38,60
11,SANTA CRUZ DE JUVENTINO ROSAS,16,61,134,211
11,TARANDACUAO,0,2,3,5
11,TARIMORO,9,8,6,23
11,URIANGATO,1,23,118,142
11,VALLE DE SANTIAGO,48,60,121,229
11,VICTORIA,0,1,4,5
11,VILLAGRAN,6,11,31,48
11,YURIRIA,20,9,58,87
12,ACAPULCO DE JUAREZ,6,4,3,13
12,AJUCHITLAN DEL PROGRESO,1,0,0,1
12,ALPOYECA,0,0,3,3
12,APAXTLA,0,2,1,3
12,ARCELIA,4,0,2,6
12,ATENANGO DEL RIO,1,0,0,1
12,ATOYAC DE ALVAREZ,49,4,1,54
12,AZOYU,4,1,0,5
12,BENITO JUAREZ,0,2,0,2
12,BUENAVISTA DE CUELLAR,0,1,0,1
12,CHILAPA DE ALVAREZ,7,12,2,21
12,CHILPANCINGO DE LOS BRAVO,4,5,4,13
12,COAHUAYUTLA DE JOSE MARIA IZAZAGA,49,3,0,52
12,COPALA,1,4,0,5
12,COPALILLO,2,0,0,2
12,COYUCA DE BENITEZ,2,4,1,7
12,COYUCA DE CATALAN,10,1,1,12
12,CUAJINICUILAPA,9,6,2,17
12,FLORENCIO VILLARREAL,0,3,0,3
12,GENERAL HELIODORO CASTILLO,2,0,0,2
12,HUAMUXTITLAN,2,0,0,2
12,HUITZUCO DE LOS FIGUEROA,3,6,0,9
12,IGUALA DE LA INDEPENDENCIA,13,6,43,62
12,IXCATEOPAN DE CUAUHTEMOC,0,1,0,1
12,ZIHUATANEJO DE AZUETA,7,8,0,15
12,LEONARDO BRAVO,0,7,0,7
12,MALINALTEPEC,3,0,0,3
12,OMETEPEC,2,0,0,2
12,PETATLAN,1,11,1,13
12,PUNGARABATO,13,3,3,19
12,SAN LUIS ACATLAN,4,0,0,4
12,SAN MARCOS,2,0,0,2
12,SAN MIGUEL TOTOLAPAN,0,0,1,1
12,TAXCO DE ALARCON,12,3,0,15
12,TECOANAPA,0,1,0,1
12,TECPAN DE GALEANA,18,5,1,24
12,TELOLOAPAN,6,0,0,6
12,TEPECOACUILCO DE TRUJANO,9,1,1,11
12,TIXTLA DE GUERRERO,3,1,0,4
12,TLACOACHISTLAHUACA,0,0,1,1
12,TLACOAPA,2,0,0,2
12,TLALCHAPA,3,1,0,4
12,TLAPA DE COMONFORT,2,1,8,11
12,TLAPEHUALA,1,0,0,1
12,LA UNION DE ISIDORO MONTES DE OCA,13,5,2,20
12,ZAPOTITLAN TABLAS,1,0,0,1
12,ZIRANDARO,1,2,0,3
12,EDUARDO NERI,3,2,0,5
12,JOSE JOAQUIN DE HERRERA,1,0,0,1
13,ACATLAN,0,11,1,12
13,ACAXOCHITLAN,6,9,0,15
13,ACTOPAN,8,2,4,14
13,AGUA BLANCA DE ITURBIDE,7,2,2,11
13,AJACUBA,2,0,0,2
13,ALFAJAYUCAN,4,0,6,10
13,ALMOLOYA,9,2,0,11
13,APAN,80,47,7,134
13,ATITALAQUIA,1,0,2,3
13,ATLAPEXCO,21,0,0,21
13,CALNALI,0,1,0,1
13,CHAPULHUACAN,2,0,0,2
13,CUAUTEPEC DE HINOJOSA,12,16,2,30
13,EMILIANO ZAPATA,24,3,2,29
13,EPAZOYUCAN,29,3,2,34
13,FRANCISCO I. MADERO,3,1,0,4
13,HUASCA DE OCAMPO,3,0,3,6
13,HUAUTLA,9,0,0,9
13,HUEJUTLA DE REYES,16,2,0,18
13,HUICHAPAN,5,4,1,10
13,IXMIQUILPAN,35,8,7,50
13,JALTOCAN,10,1,0,11
13,METEPEC,13,5,7,25
13,SAN AGUSTIN METZQUITITLAN,1,1,0,2
13,METZTITLAN,0,2,1,3
13,MINERAL DE LA REFORMA,248,17,5,270
13,MINERAL DEL CHICO,1,0,0,1
13,MINERAL DEL MONTE,1,0,0,1
13,MIXQUIAHUALA DE JUAREZ,8,2,9,19
13,NOPALA DE VILLAGRAN,0,0,2,2
13,SAN FELIPE ORIZATLAN,2,2,0,4
13,PACHUCA DE SOTO,12,2,13,27
13,PISAFLORES,1,0,0,1
13,PROGRESO DE OBREGON,1,0,2,3
13,SAN AGUSTIN TLAXIACA,28,0,0,28
13,SAN SALVADOR,1,0,1,2
13,SANTIAGO DE ANAYA,2,0,0,2
13,SANTIAGO TULANTEPEC DE LUGO GUERRERO,3,1,0,4
13,SINGUILUCAN,6,9,3,18
13,TASQUILLO,0,5,1,6
13,TECOZAUTLA,0,1,1,2
13,TENANGO DE DORIA,1,0,0,1
13,TEPEAPULCO,8,4,3,15
13,TEZONTEPEC DE ALDAMA,5,2,1,8
13,VILLA DE TEZONTEPEC,7,0,5,12
13,TIZAYUCA,5,0,15,20
13,TLANALAPA,0,2,0,2
13,TLAXCOAPAN,8,0,8,16
13,TOLCAYUCA,3,0,41,44
13,TULA DE ALLENDE,1,25,2,28
13,TULANCINGO DE BRAVO,25,17,38,80
13,ZAPOTLAN DE JUAREZ,41,0,2,43
13,ZEMPOALA,23,13,3,39
13,ZIMAPAN,0,0,5,5
14,ACATIC,3,4,147,154
14,ACATLAN DE JUAREZ,6,0,2,8
14,AHUALULCO DE MERCADO,56,6,7,69
14,AMACUECA,0,1,1,2
14,AMECA,613,214,103,930
14,SAN JUANITO DE ESCOBEDO,13,0,0,13
14,ARANDAS,3,135,100,238
14,EL ARENAL,2,0,3,5
14,ATEMAJAC DE BRIZUELA,5,4,0,9
14,ATENGO,3,4,3,10
14,ATENGUILLO,3,4,0,7
14,ATOTONILCO EL ALTO,18,167,71,256
14,AUTLAN DE NAVARRO,5,2,5,12
14,AYOTLAN,0,15,17,32
14,AYUTLA,1,0,1,2
14,LA BARCA,35,86,61,182
14,CABO CORRIENTES,0,1,0,1
14,CASIMIRO CASTILLO,1,2,5,8
14,CHAPALA,0,8,3,11
14,CHIQUILISTLAN,2,0,0,2
14,CIHUATLAN,3,0,3,6
14,ZAPOTLAN EL GRANDE,0,1,47,48
14,COCULA,39,5,1,45
14,COLOTLAN,0,0,1,1
14,CUAUTITLAN DE GARCIA BARRAGAN,2,5,3,10
14,CUAUTLA,1,0,0,1
14,CUQUIO,168,44,1,213
14,DEGOLLADO,2,3,1,6
14,ENCARNACION DE DIAZ,2,17,60,79
14,ETZATLAN,45,13,39,97
14,EL GRULLO,11,4,2,17
14,GUADALAJARA,3,83,115,201
14,HUEJUCAR,1,0,0,1
14,HUEJUQUILLA EL ALTO,5,0,2,7
14,LA HUERTA,1,2,0,3
14,IXTLAHUACAN DE LOS MEMBRILLOS,6,21,6,33
14,IXTLAHUACAN DEL RIO,59,17,20,96
14,JALOSTOTITLAN,13,13,3,29
14,JAMAY,14,4,9,27
14,JESUS MARIA,0,0,24,24
14,JILOTLAN DE LOS DOLORES,3,1,0,4
14,JOCOTEPEC,8,8,3,19
14,JUANACATLAN,0,3,2,5
14,LAGOS DE MORENO,10,31,23,64
14,EL LIMON,0,1,0,1
14,MAGDALENA,2,2,16,20
14,LA MANZANILLA DE LA PAZ,1,0,0,1
14,MASCOTA,3,1,1,5
14,MEZQUITIC,2,0,0,2
14,MEXTICACAN,0,1,0,1
14,OCOTLAN,11,18,21,50
14,OJUELOS DE JALISCO,1,1,1,3
14,PIHUAMO,17,12,1,30
14,PONCITLAN,10,24,31,65
14,VILLA PURIFICACION,13,0,0,13
14,QUITUPAN,2,1,0,3
14,SAN JUAN DE LOS LAGOS,15,136,54,205
14,GOMEZ FARIAS,1,0,0,1
14,EL SALTO,0,0,8,8
14,SAN JULIAN,9,3,1,13
14,SAN MARCOS,4,15,5,24
14,SAN MARTIN HIDALGO,57,23,7,87
14,SAN MIGUEL EL ALTO,3,1,3,7
14,SAN SEBASTIAN DEL OESTE,0,0,2,2
14,SAYULA,1,5,13,19
14,TALA,30,121,49,200
14,TAMAZULA DE GORDIANO,23,21,7,51
14,TAPALPA,6,1,0,7
14,TECALITLAN,4,3,1,8
14,TECOLOTLAN,1,8,0,9
14,TENAMAXTLAN,4,2,0,6
14,TEOCALTICHE,3,2,32,37
14,TEOCUITATLAN DE CORONA,0,0,1,1
14,TEPATITLAN DE MORELOS,8,6,53,67
14,TEQUILA,1,16,19,36
14,TEUCHITLAN,5,2,0,7
14,TLAJOMULCO DE ZUÑIGA,32,42,28,102
14,TLAQUEPAQUE,0,0,5,5
14,TOLIMAN,0,1,4,5
14,TOMATLAN,6,1,1,8
14,TONALA,1,0,2,3
14,TONILA,25,2,1,28
14,TOTOTLAN,6,18,98,122
14,TUXPAN,14,7,22,43
14,UNION DE SAN ANTONIO,26,2,5,33
14,UNION DE TULA,2,0,0,2
14,VALLE DE GUADALUPE,2,11,3,16
14,SAN GABRIEL,1,1,4,6
14,VILLA CORONA,2,2,0,4
14,VILLA GUERRERO,2,0,2,4
14,VILLA HIDALGO,0,1,0,1
14,ZACOALCO DE TORRES,0,3,5,8
14,ZAPOPAN,1,7,102,110
14,ZAPOTILTIC,11,5,40,56
14,ZAPOTITLAN DE VADILLO,15,2,0,17
14,ZAPOTLAN DEL REY,1,39,33,73
14,ZAPOTLANEJO,4,165,154,323
15,ACAMBAY,3,3,0,6
15,ACOLMAN,0,0,3,3
15,ACULCO,1,6,3,10
15,ALMOLOYA DE ALQUISIRAS,2,1,0,3
15,ALMOLOYA DE JUAREZ,8,11,3,22
15,ALMOLOYA DEL RIO,1,0,0,1
15,AMANALCO,1,4,0,5
15,AMATEPEC,1,1,0,2
15,AMECAMECA,1,0,30,31
15,APAXCO,0,2,0,2
15,ATENCO,1,0,3,4
15,ATIZAPAN,0,2,2,4
15,ATLACOMULCO,3,6,4,13
15,AXAPUSCO,0,3,1,4
15,AYAPANGO,0,3,1,4
15,CALIMAYA,0,3,5,8
15,CHALCO,0,9,12,21
15,CHAPA DE MOTA,0,0,1,1
15,CHICOLOAPAN,0,0,1,1
15,COATEPEC HARINAS,1,1,1,3
15,COYOTEPEC,0,2,0,2
15,CUAUTITLAN IZCALLI,1,2,25,28
15,DONATO GUERRA,1,2,1,4
15,ECATEPEC DE MORELOS,0,0,11,11
15,HUEHUETOCA,0,1,0,1
15,HUEYPOXTLA,0,3,2,5
15,HUIXQUILUCAN,0,2,6,8
15,IXTAPALUCA,1,7,2,10
15,IXTAPAN DE LA SAL,1,0,0,1
15,IXTLAHUACA,6,16,7,29
15,XALATLACO,0,6,1,7
15,JALTENCO,0,0,1,1
15,JILOTEPEC,4,4,1,9
15,JILOTZINGO,0,0,1,1
15,JIQUIPILCO,6,10,0,16
15,JOCOTITLAN,7,15,3,25
15,JOQUICINGO,0,1,1,2
15,JUCHITEPEC,0,6,4,10
15,MELCHOR OCAMPO,0,3,2,5
15,METEPEC,0,0,1,1
15,MORELOS,2,2,0,4
15,NAUCALPAN DE JUAREZ,0,0,18,18
15,NEZAHUALCOYOTL,0,0,6,6
15,NEXTLALPAN,0,0,1,1
15,NICOLAS ROMERO,0,1,2,3
15,NOPALTEPEC,0,1,0,1
15,OCOYOACAC,0,1,43,44
15,OCUILAN,2,1,0,3
15,EL ORO,0,4,0,4
15,OTUMBA,2,3,3,8
15,OTZOLOAPAN,0,2,0,2
15,OTZOLOTEPEC,1,4,0,5
15,OZUMBA,0,2,0,2
15,PAPALOTLA,0,0,4,4
15,LA PAZ,0,1,3,4
15,POLOTITLAN,0,3,0,3
15,RAYON,0,1,0,1
15,SAN ANTONIO LA ISLA,1,1,1,3
15,SAN FELIPE DEL PROGRESO,2,6,3,11
15,SAN MATEO ATENCO,1,1,0,2
15,SAN SIMON DE GUERRERO,1,0,1,2
15,TECAMAC,0,8,4,12
15,TEJUPILCO,1,1,0,2
15,TEMAMATLA,0,0,1,1
15,TEMASCALAPA,1,3,0,4
15,TEMASCALCINGO,1,2,0,3
15,TEMASCALTEPEC,1,4,4,9
15,TEMOAYA,2,2,3,7
15,TENANCINGO,8,11,2,21
15,TENANGO DEL AIRE,0,3,5,8
15,TENANGO DEL VALLE,2,7,6,15
15,TEOTIHUACAN,1,1,1,3
15,TEPETLAOXTOC,0,4,1,5
15,TEPOTZOTLAN,0,1,0,1
15,TEQUIXQUIAC,2,0,2,4
15,TEXCALTITLAN,1,4,1,6
15,TEXCALYACAC,0,1,0,1
15,TEXCOCO,128,2,37,167
15,TIANGUISTENCO,1,1,9,11
15,TIMILPAN,0,1,0,1
15,TLALMANALCO,0,4,0,4
15,TLALNEPANTLA DE BAZ,0,0,16,16
15,TLATLAYA,1,0,0,1
15,TOLUCA,1,9,82,92
15,TONATICO,1,0,1,2
15,TULTEPEC,0,1,0,1
15,TULTITLAN,0,0,21,21
15,VALLE DE BRAVO,0,2,3,5
15,VILLA DE ALLENDE,4,4,2,10
15,VILLA DEL CARBON,1,0,0,1
15,VILLA GUERRERO,1,2,6,9
15,VILLA VICTORIA,3,7,1,11
15,ZACAZONAPAN,0,1,0,1
15,ATIZAPAN DE ZARAGOZA,0,0,1,1
15,ZINACANTEPEC,6,43,4,53
15,ZUMPAHUACAN,0,0,2,2
15,ZUMPANGO,0,1,1,2
15,SAN JOSE DEL RINCON,6,8,3,17
16,ACUITZIO,2,0,1,3
16,AGUILILLA,0,1,2,3
16,ALVARO OBREGON,11,4,6,21
16,ANGAMACUTIRO,10,1,0,11
16,APATZINGAN,21,16,8,45
16,AQUILA,1,0,0,1
16,ARIO,4,4,11,19
16,BRISEÑAS,6,5,9,20
16,BUENAVISTA,23,15,0,38
16,CARACUARO,2,0,0,2
16,CHAVINDA,13,4,1,18
16,CHILCHOTA,0,14,1,15
16,CHURINTZIO,4,6,1,11
16,CHURUMUCO,0,2,0,2
16,COAHUAYANA,1,3,0,4
16,COALCOMAN DE VAZQUEZ PALLARES,1,0,0,1
16,CONTEPEC,10,5,3,18
16,COPANDARO,0,1,1,2
16,COTIJA,0,3,0,3
16,CUITZEO,1,1,16,18
16,ECUANDUREO,0,9,1,10
16,EPITACIO HUERTA,0,3,0,3
16,GABRIEL ZAMORA,13,17,2,32
16,LA HUACANA,1,1,0,2
16,HUETAMO,7,1,0,8
16,HUIRAMBA,0,0,1,1
16,INDAPARAPEO,17,4,3,24
16,IRIMBO,1,1,0,2
16,IXTLAN,0,9,1,10
16,JACONA,7,41,48,96
16,JIMENEZ,0,0,10,10
16,JIQUILPAN,3,6,3,12
16,JOSE SIXTO VERDUZCO,20,5,8,33
16,JUNGAPEO,1,0,0,1
16,LAGUNILLAS,0,0,1,1
16,MADERO,1,5,5,11
16,MARAVATIO,2,17,0,19
16,MARCOS CASTELLANOS,0,6,1,7
16,LAZARO CARDENAS,1,12,6,19
16,MORELIA,15,16,30,61
16,NAHUATZEN,0,0,1,1
16,NOCUPETARO,1,0,0,1
16,NUEVO PARANGARICUTIRO,2,29,2,33
16,NUEVO URECHO,0,3,1,4
16,NUMARAN,8,9,2,19
16,OCAMPO,5,0,1,6
16,PAJACUARAN,1,2,1,4
16,PARACHO,0,3,0,3
16,PARACUARO,2,3,2,7
16,PATZCUARO,0,2,7,9
16,PENJAMILLO,2,1,4,7
16,PERIBAN,5,19,23,47
16,LA PIEDAD,22,37,40,99
16,PUREPERO,0,1,0,1
16,PURUANDIRO,30,15,42,87
16,QUERENDARO,10,5,4,19
16,QUIROGA,13,299,28,340
16,COJUMATLAN DE REGULES,0,5,0,5
16,LOS REYES,24,42,48,114
16,SAHUAYO,0,0,1,1
16,SAN LUCAS,5,0,1,6
16,SANTA ANA MAYA,5,2,5,12
16,SALVADOR ESCALANTE,1,4,4,9
16,SENGUIO,0,1,1,2
16,SUSUPUATO,0,0,1,1
16,TACAMBARO,6,32,16,54
16,TANCITARO,4,32,28,64
16,TANGAMANDAPIO,1,3,4,8
16,TANGANCICUARO,2,35,1,38
16,TANHUATO,1,3,12,16
16,TARETAN,1,2,0,3
16,TARIMBARO,2,8,0,10
16,TEPALCATEPEC,5,3,4,12
16,TINGAMBATO,3,1,2,6
16,TINGüINDIN,3,0,0,3
16,TIQUICHEO DE NICOLAS ROMERO,3,0,0,3
16,TLALPUJAHUA,0,2,0,2
16,TOCUMBO,0,3,0,3
16,TUMBISCATIO,1,0,1,2
16,TUXPAN,0,2,0,2
16,TUZANTLA,2,1,0,3
16,TZINTZUNTZAN,0,1,0,1
16,TZITZIO,2,0,0,2
16,URUAPAN,11,60,121,192
16,VENUSTIANO CARRANZA,1,11,11,23
16,VILLAMAR,0,3,2,5
16,VISTA HERMOSA,17,4,5,26
16,YURECUARO,7,50,46,103
16,ZACAPU,13,7,8,28
16,ZAMORA,17,140,105,262
16,MUGICA,2,7,4,13
16,ZINAPARO,2,1,0,3
16,ZINAPECUARO,18,10,1,29
16,ZITACUARO,2,8,3,13
17,AMACUZAC,0,10,1,11
17,ATLATLAHUCAN,1,1,7,9
17,AXOCHIAPAN,12,2,0,14
17,AYALA,16,20,0,36
17,COATLAN DEL RIO,4,0,0,4
17,CUAUTLA,73,64,26,163
17,CUERNAVACA,7,0,1,8
17,EMILIANO ZAPATA,4,0,0,4
17,HUITZILAC,0,3,0,3
17,JIUTEPEC,1,0,1,2
17,JOJUTLA,2,11,0,13
17,JONACATEPEC,4,5,0,9
17,MAZATEPEC,2,2,1,5
17,MIACATLAN,7,2,0,9
17,OCUITUCO,1,0,0,1
17,PUENTE DE IXTLA,3,6,1,10
17,TEMIXCO,0,0,1,1
17,TEMOAC,1,0,0,1
17,TEPALCINGO,4,1,0,5
17,TEPOZTLAN,1,0,1,2
17,TETECALA,0,0,1,1
17,TETELA DEL VOLCAN,1,0,0,1
17,TLALNEPANTLA,0,2,0,2
17,TLALTIZAPAN,3,1,1,5
17,TLAQUILTENANGO,5,1,0,6
17,TLAYACAPAN,2,1,0,3
17,XOCHITEPEC,0,1,0,1
17,YAUTEPEC,8,1,2,11
17,YECAPIXTLA,7,7,2,16
17,ZACATEPEC,22,15,16,53
17,ZACUALPAN,1,0,0,1
18,ACAPONETA,10,19,19,48
18,AHUACATLAN,3,3,0,6
18,AMATLAN DE CAÑAS,11,24,27,62
18,COMPOSTELA,47,24,8,79
18,IXTLAN DEL RIO,10,105,27,142
18,JALA,3,1,4,8
18,XALISCO,9,2,0,11
18,ROSAMORADA,18,14,6,38
18,RUIZ,12,3,0,15
18,SAN BLAS,7,6,7,20
18,SAN PEDRO LAGUNILLAS,17,0,1,18
18,SANTA MARIA DEL ORO,6,2,4,12
18,SANTIAGO IXCUINTLA,49,32,27,108
18,TECUALA,12,8,11,31
18,TEPIC,1966,948,391,3305
18,TUXPAN,17,3,2,22
18,BAHIA DE BANDERAS,13,6,5,24
19,AGUALEGUAS,0,0,6,6
19,ALLENDE,3,39,5,47
19,ANAHUAC,2,1,1,4
19,ARAMBERRI,17,0,2,19
19,CADEREYTA JIMENEZ,0,3,29,32
19,CARMEN,0,2,0,2
19,CERRALVO,0,0,3,3
19,CHINA,32,11,4,47
19,CIENEGA DE FLORES,8,19,0,27
19,DR. ARROYO,3,4,1,8
19,DR. COSS,0,1,0,1
19,DR. GONZALEZ,0,1,3,4
19,GALEANA,1,14,29,44
19,GARCIA,0,3,4,7
19,GRAL. BRAVO,0,0,3,3
19,GRAL. TERAN,2,10,2,14
19,GRAL. ZUAZUA,12,62,0,74
19,GUADALUPE,0,0,22,22
19,HIDALGO,2,14,0,16
19,HUALAHUISES,0,2,1,3
19,JUAREZ,0,5,0,5
19,LINARES,1,9,23,33
19,MINA,0,1,0,1
19,MONTEMORELOS,8,123,25,156
19,MONTERREY,1,2,15,18
19,PARAS,0,0,5,5
19,PESQUERIA,0,4,2,6
19,LOS RAMONES,0,2,1,3
19,SABINAS HIDALGO,0,0,23,23
19,SALINAS VICTORIA,8,20,3,31
19,SAN NICOLAS DE LOS GARZA,0,0,14,14
19,SANTA CATARINA,0,0,8,8
19,SANTIAGO,7,54,0,61
19,VALLECILLO,0,0,5,5
20,ACATLAN DE PEREZ FIGUEROA,3,6,4,13
20,ASUNCION NOCHIXTLAN,0,2,0,2
20,CANDELARIA LOXICHA,2,3,0,5
20,CHAHUITES,7,36,15,58
20,CHALCATONGO DE HIDALGO,1,1,0,2
20,CIUDAD IXTEPEC,0,0,1,1
20,COICOYAN DE LAS FLORES,1,0,0,1
20,COSOLAPA,0,0,3,3
20,HEROICA CIUDAD DE EJUTLA DE CRESPO,4,13,3,20
20,FRESNILLO DE TRUJANO,0,1,0,1
20,VILLA HIDALGO,5,0,1,6
20,HEROICA CIUDAD DE HUAJUAPAN DE LEON,12,5,1,18
20,IXTLAN DE JUAREZ,6,0,0,6
20,HEROICA CIUDAD DE JUCHITAN DE ZARAGOZA,3,5,0,8
20,LOMA BONITA,2,5,2,9
20,MAGDALENA APASCO,6,0,1,7
20,MARISCALA DE JUAREZ,2,0,0,2
20,MATIAS ROMERO AVENDAÑO,3,3,2,8
20,MIAHUATLAN DE PORFIRIO DIAZ,4,4,6,14
20,SANTIAGO NILTEPEC,3,8,1,12
20,OAXACA DE JUAREZ,11,5,1,17
20,OCOTLAN DE MORELOS,3,1,0,4
20,LA PE,0,0,1,1
20,SAN JOSE DEL PROGRESO,0,1,0,1
20,PUTLA VILLA DE GUERRERO,7,1,0,8
20,REFORMA DE PINEDA,0,3,2,5
20,SALINA CRUZ,2,4,0,6
20,SAN AGUSTIN ETLA,2,1,0,3
20,SAN AGUSTIN LOXICHA,3,2,0,5
20,SAN ANDRES HUAXPALTEPEC,2,1,0,3
20,SAN ANDRES SINAXTLA,1,1,1,3
20,SAN ANTONINO MONTE VERDE,0,1,0,1
20,SAN ANTONIO DE LA CAL,0,3,0,3
20,SAN ANTONIO TEPETLAPA,4,1,0,5
20,SAN BARTOLOME AYAUTLA,1,0,0,1
20,SAN BARTOLOME LOXICHA,1,0,0,1
20,SAN BLAS ATEMPA,1,0,0,1
20,SAN DIONISIO OCOTEPEC,1,0,0,1
20,SAN FELIPE JALAPA DE DIAZ,1,0,0,1
20,SAN FRANCISCO DEL MAR,0,3,0,3
20,SAN FRANCISCO IXHUATAN,1,0,1,2
20,SAN FRANCISCO LACHIGOLO,4,1,0,5
20,SAN FRANCISCO TELIXTLAHUACA,2,2,0,4
20,SAN ILDEFONSO AMATLAN,1,0,0,1
20,SAN JOSE CHILTEPEC,0,0,1,1
20,SAN JUAN BAUTISTA ATATLAHUCA,1,0,1,2
20,SAN JUAN BAUTISTA CUICATLAN,1,1,0,2
20,SAN JUAN BAUTISTA TUXTEPEC,39,32,19,90
20,SAN JUAN BAUTISTA VALLE NACIONAL,0,0,1,1
20,SAN JUAN COATZOSPAM,0,0,2,2
20,SAN JUAN COTZOCON,2,13,4,19
20,SAN JUAN LACHIGALLA,2,0,0,2
20,SAN JUAN LALANA,0,0,1,1
20,SAN JUAN MAZATLAN,1,0,0,1
20,SAN JUAN MIXTEPEC -DTO. 08 -,2,0,0,2
20,SAN JUAN TAMAZOLA,1,0,0,1
20,SAN JUAN TEPOSCOLULA,0,0,1,1
20,SAN LORENZO CACAOTEPEC,3,0,0,3
20,SAN LUCAS QUIAVINI,0,0,1,1
20,SAN MARTIN PERAS,2,0,0,2
20,SAN MARTIN ZACATEPEC,1,0,0,1
20,SAN MIGUEL AMATITLAN,0,0,1,1
20,SAN MIGUEL AMATLAN,0,0,1,1
20,SAN MIGUEL CHIMALAPA,2,1,0,3
20,SAN MIGUEL COATLAN,1,0,0,1
20,SAN MIGUEL EL GRANDE,1,7,0,8
20,VILLA SOLA DE VEGA,1,1,0,2
20,SAN MIGUEL SOYALTEPEC,1,0,0,1
20,SAN PABLO COATLAN,0,0,1,1
20,SAN PABLO ETLA,5,1,0,6
20,SAN PABLO HUIXTEPEC,1,1,2,4
20,SAN PEDRO AMUZGOS,0,2,1,3
20,SAN PEDRO APOSTOL,1,1,0,2
20,SAN PEDRO COMITANCILLO,0,1,0,1
20,SAN PEDRO MIXTEPEC -DTO. 22 -,12,6,1,19
20,SAN PEDRO POCHUTLA,12,2,2,16
20,SAN PEDRO TAPANATEPEC,5,14,17,36
20,SAN PEDRO TAVICHE,1,0,0,1
20,SAN PEDRO TOTOLAPA,2,0,0,2
20,VILLA DE TUTUTEPEC DE MELCHOR OCAMPO,1,7,2,10
20,VILLA DE ETLA,3,1,0,4
20,SAN PEDRO Y SAN PABLO TEPOSCOLULA,1,0,0,1
20,SAN SEBASTIAN RIO HONDO,1,0,0,1
20,SANTA CATARINA JUQUILA,9,1,0,10
20,SANTA CATARINA MECHOACAN,0,1,0,1
20,SANTA CRUZ ITUNDUJIA,4,0,0,4
20,SANTA CRUZ TACACHE DE MINA,1,0,0,1
20,SANTA CRUZ XITLA,1,0,0,1
20,SANTA CRUZ XOXOCOTLAN,3,0,1,4
20,SANTA GERTRUDIS,2,0,0,2
20,HEROICA CIUDAD DE TLAXIACO,0,4,0,4
20,AYOQUEZCO DE ALDAMA,0,5,0,5
20,SANTA MARIA ATZOMPA,1,4,1,6
20,SANTA MARIA CAMOTLAN,0,2,0,2
20,SANTA MARIA COLOTEPEC,0,0,4,4
20,SANTA MARIA CORTIJO,2,1,1,4
20,SANTA MARIA COYOTEPEC,0,1,0,1
20,SANTA MARIA GUIENAGATI,6,0,0,6
20,SANTA MARIA HUATULCO,4,15,2,21
20,SANTA MARIA HUAZOLOTITLAN,0,3,1,4
20,SANTA MARIA IPALAPA,1,3,0,4
20,SANTA MARIA JACATEPEC,0,0,2,2
20,SANTA MARIA JALAPA DEL MARQUES,1,0,0,1
20,SANTA MARIA NATIVITAS,0,0,1,1
20,SANTA MARIA TONAMECA,3,7,2,12
20,SANTA MARIA TOTOLAPILLA,1,1,0,2
20,SANTA MARIA ZACATEPEC,7,3,0,10
20,SANTA MARIA ZOQUITLAN,1,0,0,1
20,SANTIAGO AMOLTEPEC,0,0,1,1
20,SANTIAGO ASTATA,1,0,0,1
20,SANTIAGO HUAJOLOTITLAN,1,0,0,1
20,SANTIAGO IHUITLAN PLUMAS,0,0,1,1
20,SANTIAGO JAMILTEPEC,4,2,1,7
20,SANTIAGO JUXTLAHUACA,1,0,0,1
20,SANTIAGO LLANO GRANDE,4,3,1,8
20,SANTIAGO MATATLAN,1,1,1,3
20,SANTIAGO PINOTEPA NACIONAL,6,5,1,12
20,SANTIAGO SUCHILQUITONGO,0,3,0,3
20,SANTIAGO TAMAZOLA,0,1,0,1
20,SANTIAGO TAPEXTLA,5,11,2,18
20,VILLA TEJUPAM DE LA UNION,0,0,1,1
20,SANTIAGO TEPETLAPA,0,0,1,1
20,SANTIAGO TEXTITLAN,1,1,0,2
20,SANTIAGO TILLO,0,2,0,2
20,SANTIAGO YAVEO,1,4,4,9
20,SANTIAGO YOSONDUA,1,1,0,2
20,NUEVO ZOQUIAPAM,5,2,0,7
20,SANTO DOMINGO INGENIO,1,3,1,5
20,SANTO DOMINGO ARMENTA,0,4,0,4
20,SANTO DOMINGO CHIHUITAN,1,0,0,1
20,SANTO DOMINGO DE MORELOS,1,0,0,1
20,SANTO DOMINGO TEHUANTEPEC,4,5,0,9
20,SANTO DOMINGO TONALA,1,1,0,2
20,SANTO DOMINGO ZANATEPEC,10,6,1,17
20,SANTOS REYES TEPEJILLO,0,0,1,1
20,VILLA DE TAMAZULAPAM DEL PROGRESO,1,1,0,2
20,TEOCOCUILCO DE MARCOS PEREZ,1,0,1,2
20,TEZOATLAN DE SEGURA Y LUNA,2,2,0,4
20,TLACOLULA DE MATAMOROS,1,2,0,3
20,TLALIXTAC DE CABRERA,0,0,3,3
20,TOTONTEPEC VILLA DE MORELOS,1,0,0,1
20,TRINIDAD ZAACHILA,0,0,1,1
20,UNION HIDALGO,0,4,1,5
20,YAXE,0,0,1,1
20,VILLA DE ZAACHILA,9,2,1,12
20,ZIMATLAN DE ALVAREZ,15,3,4,22
21,ACAJETE,4,1,0,5
21,ACATENO,3,0,0,3
21,ACATLAN,5,0,0,5
21,ACATZINGO,3,3,1,7
21,ACTEOPAN,5,0,0,5
21,AHUATLAN,1,0,0,1
21,AJALPAN,0,0,1,1
21,ALJOJUCA,2,2,0,4
21,AMOZOC,10,0,0,10
21,AQUIXTLA,22,8,0,30
21,ATEMPAN,4,0,0,4
21,ATEXCAL,1,0,0,1
21,ATLIXCO,2,2,7,11
21,ATOYATEMPAN,1,1,0,2
21,ATZITZIHUACAN,3,0,0,3
21,AYOTOXCO DE GUERRERO,6,2,0,8
21,CALPAN,0,1,0,1
21,CHALCHICOMULA DE SESMA,3,2,3,8
21,CHIAUTLA,3,2,0,5
21,CHIAUTZINGO,7,5,1,13
21,CHIETLA,25,22,23,70
21,CHIGMECATITLAN,2,0,0,2
21,CHIGNAHUAPAN,17,13,5,35
21,CHIGNAUTLA,5,2,0,7
21,COHUECAN,1,0,0,1
21,CORONANGO,0,1,0,1
21,COXCATLAN,1,0,0,1
21,COYOMEAPAN,2,0,0,2
21,COYOTEPEC,0,3,1,4
21,CUAUTEMPAN,2,1,0,3
21,CUETZALAN DEL PROGRESO,20,1,0,21
21,CUYOACO,8,13,5,26
21,DOMINGO ARENAS,0,0,1,1
21,ELOXOCHITLAN,2,0,0,2
21,FRANCISCO Z. MENA,5,2,0,7
21,GUADALUPE VICTORIA,2,4,0,6
21,HUAQUECHULA,8,2,1,11
21,HUAUCHINANGO,26,1,0,27
21,HUEHUETLA,1,0,0,1
21,HUEHUETLAN EL CHICO,2,2,0,4
21,HUEJOTZINGO,5,5,2,12
21,HUEYTAMALCO,6,5,5,16
21,IXCAQUIXTLA,1,0,0,1
21,IXTACAMAXTITLAN,1,2,0,3
21,IZUCAR DE MATAMOROS,0,3,1,4
21,JOLALPAN,3,2,0,5
21,JUAN C. BONILLA,4,0,0,4
21,JUAN GALINDO,0,0,1,1
21,LAFRAGUA,1,3,0,4
21,LIBRES,7,3,8,18
21,MOLCAXAC,1,0,0,1
21,NICOLAS BRAVO,1,1,2,4
21,NOPALUCAN,7,10,1,18
21,OCOTEPEC,1,1,0,2
21,OCOYUCAN,0,0,2,2
21,OLINTLA,2,0,0,2
21,ORIENTAL,2,1,1,4
21,PAHUATLAN,3,0,0,3
21,PALMAR DE BRAVO,3,2,0,5
21,PANTEPEC,1,1,0,2
21,PUEBLA,12,1,16,29
21,QUECHOLAC,5,8,0,13
21,RAFAEL LARA GRAJALES,1,0,1,2
21,SAN GABRIEL CHILAC,0,0,1,1
21,SAN JOSE CHIAPA,0,0,1,1
21,SAN JOSE MIAHUATLAN,0,2,0,2
21,SAN JUAN ATENCO,3,2,1,6
21,SAN MARTIN TEXMELUCAN,5,2,3,10
21,SAN MATIAS TLALANCALECA,3,1,0,4
21,SAN MIGUEL XOXTLA,0,1,0,1
21,SAN NICOLAS BUENOS AIRES,6,4,0,10
21,SAN NICOLAS DE LOS RANCHOS,2,0,0,2
21,SAN PEDRO CHOLULA,0,2,3,5
21,SAN SALVADOR EL SECO,2,0,17,19
21,SAN SALVADOR EL VERDE,3,2,0,5
21,SAN SALVADOR HUIXCOLOTLA,0,2,1,3
21,SAN SEBASTIAN TLACOTEPEC,1,0,0,1
21,SANTA ISABEL CHOLULA,0,0,1,1
21,SANTO TOMAS HUEYOTLIPAN,0,0,1,1
21,SOLTEPEC,0,0,1,1
21,TECALI DE HERRERA,5,0,0,5
21,TECAMACHALCO,14,8,23,45
21,TECOMATLAN,0,1,1,2
21,TEHUACAN,6,3,3,12
21,TEHUITZINGO,1,0,1,2
21,TENAMPULCO,0,0,3,3
21,TEOTLALCO,0,1,0,1
21,TEPANCO DE LOPEZ,2,0,16,18
21,TEPEACA,7,4,0,11
21,TEPEOJUMA,1,0,0,1
21,TEPEXCO,2,1,0,3
21,TEPEXI DE RODRIGUEZ,1,0,1,2
21,TEPEYAHUALCO,15,3,17,35
21,TETELA DE OCAMPO,4,5,1,10
21,TETELES DE AVILA CASTILLO,1,0,0,1
21,TILAPA,1,0,0,1
21,TLACHICHUCA,23,7,6,36
21,TLACOTEPEC DE BENITO JUAREZ,5,0,3,8
21,TLACUILOTEPEC,3,0,0,3
21,TLAHUAPAN,9,13,3,25
21,TLAOLA,2,0,0,2
21,TLAPANALA,0,2,0,2
21,TLATLAUQUITEPEC,8,4,2,14
21,TLAXCO,2,0,0,2
21,TOCHTEPEC,0,1,0,1
21,TULCINGO,1,1,0,2
21,TZICATLACOYAN,0,1,0,1
21,VENUSTIANO CARRANZA,2,3,0,5
21,XICOTEPEC,50,10,6,66
21,XIUTETELCO,3,0,0,3
21,XOCHITLÁN DE VICENTE SUÁREZ,1,1,0,2
21,XOCHITLAN TODOS SANTOS,21,3,0,24
21,YAONAHUAC,1,0,0,1
21,YEHUALTEPEC,3,2,1,6
21,ZACAPOAXTLA,4,2,2,8
21,ZACATLAN,1,1,7,9
21,ZAPOTITLAN,2,0,0,2
21,ZARAGOZA,0,1,0,1
21,ZAUTLA,1,3,0,4
21,ZIHUATEUTLA,10,1,11,22
21,ZONGOZOTLA,2,1,0,3
22,AMEALCO DE BONFIL,11,25,12,48
22,PINAL DE AMOLES,0,1,1,2
22,ARROYO SECO,0,0,2,2
22,CADEREYTA DE MONTES,0,8,7,15
22,COLON,5,8,28,41
22,CORREGIDORA,1,1,5,7
22,EZEQUIEL MONTES,0,2,88,90
22,HUIMILPAN,1,2,9,12
22,JALPAN DE SERRA,0,3,3,6
22,LANDA DE MATAMOROS,0,0,1,1
22,EL MARQUES,25,6,39,70
22,PEDRO ESCOBEDO,14,12,90,116
22,PEÑAMILLER,0,0,1,1
22,QUERETARO,5,4,24,33
22,SAN JOAQUIN,0,0,1,1
22,SAN JUAN DEL RIO,6,4,40,50
22,TEQUISQUIAPAN,2,3,2,7
22,TOLIMAN,2,2,0,4
23,BENITO JUAREZ,0,0,30,30
23,JOSE MARIA MORELOS,2,2,1,5
23,FELIPE CARRILLO PUERTO,59,46,1,106
23,LAZARO CARDENAS,0,6,0,6
23,OTHON P. BLANCO,294,378,164,836
23,SOLIDARIDAD,5,3,2,10
23,TULUM,7,4,0,11
24,AHUALULCO,0,5,0,5
24,ALAQUINES,0,0,1,1
24,AQUISMON,0,2,0,2
24,CARDENAS,0,0,1,1
24,CIUDAD FERNANDEZ,5,4,2,11
24,CEDRAL,0,0,5,5
24,CERRITOS,0,3,0,3
24,CERRO DE SAN PEDRO,0,0,1,1
24,CIUDAD VALLES,23,19,48,90
24,CIUDAD DEL MAIZ,0,3,10,13
24,EBANO,12,21,9,42
24,GUADALCAZAR,9,2,0,11
24,VILLA DE GUADALUPE,0,5,1,6
24,MATEHUALA,0,1,4,5
24,MEXQUITIC DE CARMONA,1,2,1,4
24,MOCTEZUMA,1,3,0,4
24,VILLA DE RAMOS,11,7,5,23
24,RIOVERDE,4,10,10,24
24,SALINAS,1,2,5,8
24,SAN LUIS POTOSI,2,8,29,39
24,SANTA MARIA DEL RIO,12,55,1,68
24,SANTO DOMINGO,7,7,0,14
24,TAMASOPO,7,5,2,14
24,TAMAZUNCHALE,0,0,1,1
24,TAMPAMOLON CORONA,1,1,0,2
24,TAMUIN,6,21,70,97
24,SAN VICENTE TANCUAYALAB,0,4,14,18
24,TANLAJAS,0,0,1,1
24,TANQUIAN DE ESCOBEDO,0,1,1,2
24,TIERRA NUEVA,2,0,0,2
24,VENADO,2,8,2,12
24,VANEGAS,0,1,0,1
24,VILLA DE ARRIAGA,9,9,3,21
24,VILLA HIDALGO,4,0,0,4
24,VILLA DE ARISTA,1,0,0,1
24,VILLA DE REYES,5,28,4,37
24,VILLA JUAREZ,1,2,2,5
24,XILITLA,0,0,1,1
24,ZARAGOZA,1,0,0,1
24,EL NARANJO,374,143,78,595
25,AHOME,161,217,787,1165
25,ANGOSTURA,29,45,53,127
25,CHOIX,0,3,4,7
25,CONCORDIA,0,0,1,1
25,COSALA,0,1,0,1
25,CULIACAN,167,278,646,1091
25,EL FUERTE,22,34,137,193
25,ELOTA,20,46,16,82
25,ESCUINAPA,5,7,19,31
25,GUASAVE,121,176,302,599
25,MAZATLAN,38,44,67,149
25,MOCORITO,4,5,11,20
25,NAVOLATO,35,24,126,185
25,ROSARIO,19,13,15,47
25,SALVADOR ALVARADO,22,62,145,229
25,SAN IGNACIO,1,1,2,4
25,SINALOA,59,50,66,175
26,ACONCHI,16,5,2,23
26,AGUA PRIETA,3,7,39,49
26,ALAMOS,43,24,1,68
26,ALTAR,3,3,0,6
26,ARIVECHI,16,3,1,20
26,ARIZPE,5,9,1,15
26,ATIL,3,0,0,3
26,BACADEHUACHI,11,10,0,21
26,BACANORA,10,5,0,15
26,BACERAC,3,0,1,4
26,BACOACHI,5,1,0,6
26,BACUM,18,32,27,77
26,BANAMICHI,8,2,1,11
26,BAVIACORA,9,16,5,30
26,BAVISPE,6,5,1,12
26,BENITO JUAREZ,8,23,30,61
26,BENJAMIN HILL,1,2,0,3
26,CABORCA,31,29,87,147
26,CAJEME,57,113,399,569
26,CANANEA,1,1,0,2
26,CARBO,3,6,3,12
26,LA COLORADA,15,24,2,41
26,CUCURPE,8,3,6,17
26,CUMPAS,6,7,13,26
26,DIVISADEROS,15,13,0,28
26,EMPALME,5,15,4,24
26,ETCHOJOA,48,43,39,130
26,FRONTERAS,13,6,1,20
26,GRANADOS,2,0,33,35
26,GUAYMAS,35,47,180,262
26,SAN IGNACIO RIO MUERTO,18,29,29,76
26,HERMOSILLO,55,33,304,392
26,HUACHINERA,6,2,4,12
26,HUASABAS,3,0,0,3
26,HUATABAMPO,27,34,81,142
26,HUEPAC,1,5,1,7
26,IMURIS,0,1,0,1
26,MAGDALENA,18,2,0,20
26,MAZATAN,3,9,1,13
26,MOCTEZUMA,9,11,3,23
26,NACO,1,0,0,1
26,NACORI CHICO,29,12,7,48
26,NACOZARI DE GARCIA,5,0,0,5
26,NAVOJOA,161,95,187,443
26,NOGALES,2,0,0,2
26,ONAVAS,27,8,0,35
26,OPODEPE,9,11,2,22
26,VILLA HIDALGO,2,2,0,4
26,OQUITOA,1,0,0,1
26,PITIQUITO,15,5,1,21
26,GENERAL PLUTARCO ELIAS CALLES,1,0,0,1
26,PUERTO PEÑASCO,0,5,23,28
26,QUIRIEGO,3,8,3,14
26,RAYON,1,5,5,11
26,ROSARIO,73,19,1,93
26,SAHUARIPA,86,23,5,114
26,SAN FELIPE DE JESUS,6,0,0,6
26,SAN JAVIER,0,1,0,1
26,SAN LUIS RIO COLORADO,187,117,34,338
26,SAN MIGUEL DE HORCASITAS,7,6,4,17
26,SAN PEDRO DE LA CUEVA,3,5,0,8
26,SANTA ANA,9,3,1,13
26,SANTA CRUZ,2,2,0,4
26,SARIC,6,5,1,12
26,SOYOPA,22,6,0,28
26,SUAQUI GRANDE,13,4,0,17
26,TEPACHE,2,1,0,3
26,TRINCHERAS,6,5,2,13
26,TUBUTAMA,3,1,0,4
26,URES,50,49,11,110
26,VILLA PESQUEIRA,23,16,1,40
26,YECORA,57,18,3,78
27,BALANCAN,10,22,17,49
27,CARDENAS,58,43,95,196
27,CENTLA,16,4,0,20
27,CENTRO,23,62,19,104
27,COMALCALCO,109,69,4,182
27,CUNDUACAN,1,3,0,4
27,EMILIANO ZAPATA,31,27,3,61
27,HUIMANGUILLO,24,35,51,110
27,JALAPA,3,0,3,6
27,JALPA DE MENDEZ,2,0,0,2
27,JONUTA,24,5,5,34
27,MACUSPANA,13,27,19,59
27,NACAJUCA,0,2,1,3
27,PARAISO,3,3,0,6
27,TEAPA,4,20,11,35
27,TENOSIQUE,14,11,6,31
27,TACOTALPA,6,0,3,9
28,ABASOLO,16,9,57,82
28,ALDAMA,6,2,95,103
28,ALTAMIRA,5,17,17,39
28,ANTIGUO MORELOS,20,17,10,47
28,BURGOS,1,2,4,7
28,BUSTAMANTE,2,1,0,3
28,CAMARGO,4,3,5,12
28,CASAS,4,11,6,21
28,CIUDAD MADERO,0,1,0,1
28,CRUILLAS,0,0,2,2
28,GUSTAVO DIAZ ORDAZ,31,20,14,65
28,GOMEZ FARIAS,1,2,3,6
28,GONZALEZ,16,29,107,152
28,GüEMEZ,0,3,10,13
28,HIDALGO,1,7,13,21
28,JAUMAVE,0,2,0,2
28,JIMENEZ,1,0,10,11
28,LLERA,0,8,15,23
28,MAINERO,0,1,1,2
28,EL MANTE,54,38,60,152
28,MATAMOROS,34,48,89,171
28,MENDEZ,39,18,5,62
28,MIER,0,0,1,1
28,MIGUEL ALEMAN,0,0,4,4
28,MIQUIHUANA,1,0,0,1
28,NUEVO LAREDO,0,0,2,2
28,NUEVO MORELOS,23,11,4,38
28,OCAMPO,104,65,34,203
28,PADILLA,3,5,9,17
28,PALMILLAS,0,1,0,1
28,REYNOSA,31,15,76,122
28,RIO BRAVO,71,72,140,283
28,SAN CARLOS,0,7,5,12
28,SAN FERNANDO,43,38,187,268
28,SOTO LA MARINA,7,6,47,60
28,TAMPICO,0,2,10,12
28,TULA,0,1,7,8
28,VALLE HERMOSO,99,55,137,291
28,VICTORIA,2,6,23,31
28,VILLAGRAN,4,0,1,5
28,XICOTENCATL,29,33,12,74
29,APETATITLAN DE ANTONIO CARVAJAL,1,0,2,3
29,ATLANGATEPEC,5,1,1,7
29,ALTZAYANCA,10,2,0,12
29,APIZACO,2,5,0,7
29,CALPULALPAN,20,5,1,26
29,EL CARMEN TEQUEXQUITLA,0,1,0,1
29,CHIAUTEMPAN,0,0,1,1
29,CUAPIAXTLA,20,6,0,26
29,CUAXOMULCO,1,0,0,1
29,MUÑOZ DE DOMINGO ARENAS,10,2,0,12
29,ESPAÑITA,5,1,0,6
29,HUAMANTLA,9,5,5,19
29,HUEYOTLIPAN,10,6,1,17
29,IXTACUIXTLA DE MARIANO MATAMOROS,10,5,1,16
29,IXTENCO,1,0,0,1
29,TEPETITLA DE LARDIZABAL,0,2,0,2
29,LAZARO CARDENAS,14,3,0,17
29,NANACAMILPA DE MARIANO ARISTA,11,1,0,12
29,NATIVITAS,1,0,0,1
29,SAN PABLO DEL MONTE,0,1,0,1
29,TOCATLAN,1,2,0,3
29,TERRENATE,1,1,1,3
29,TETLATLAHUCA,1,3,4,8
29,TLAXCALA,3,3,1,7
29,TLAXCO,22,4,0,26
29,TZOMPANTEPEC,8,0,2,10
29,XALOZTOC,3,6,0,9
29,XALTOCAN,5,1,0,6
29,PAPALOTLA DE XICOHTENCATL,1,0,0,1
29,BENITO JUAREZ,1,2,0,3
29,SAN JOSE TEACALCO,2,0,0,2
29,SANCTORUM DE LAZARO CARDENAS,1,1,0,2
30,ACAYUCAN,14,22,13,49
30,ACTOPAN,1,1,2,4
30,ACULA,3,1,0,4
30,CAMARON DE TEJEDA,1,0,0,1
30,ALTO LUCERO DE GUTIERREZ BARRIOS,1,0,0,1
30,ALTOTONGA,1,0,0,1
30,ALVARADO,0,2,0,2
30,AMATITLAN,0,1,0,1
30,AMATLAN DE LOS REYES,0,1,5,6
30,ANGEL R. CABADA,2,1,4,7
30,LA ANTIGUA,13,10,13,36
30,APAZAPAN,1,0,0,1
30,ATLAHUILCO,1,0,0,1
30,ATOYAC,16,17,12,45
30,ATZALAN,3,1,2,6
30,AYAHUALULCO,1,2,1,4
30,BENITO JUAREZ,1,0,0,1
30,BOCA DEL RIO,0,0,1,1
30,CARRILLO PUERTO,0,1,0,1
30,CATEMACO,3,1,1,5
30,CAZONES DE HERRERA,1,0,0,1
30,CHACALTIANGUIS,2,0,1,3
30,CHICONTEPEC,5,0,0,5
30,CHINAMECA,4,0,1,5
30,LAS CHOAPAS,9,19,1,29
30,CITLALTEPETL,0,0,1,1
30,COATEPEC,9,2,11,22
30,COATZACOALCOS,2,0,0,2
30,COATZINTLA,2,0,0,2
30,COLIPA,1,0,0,1
30,COSAUTLAN DE CARVAJAL,0,2,0,2
30,CORDOBA,16,2,24,42
30,COSAMALOAPAN DE CARPIO,10,12,14,36
30,COSCOMATEPEC,0,2,13,15
30,COTAXTLA,3,1,0,4
30,COXQUIHUI,1,0,0,1
30,COYUTLA,5,0,0,5
30,CUICHAPA,11,10,9,30
30,CUITLAHUAC,0,0,5,5
30,EMILIANO ZAPATA,0,0,8,8
30,ESPINAL,2,0,0,2
30,FORTIN,1,1,10,12
30,GUTIERREZ ZAMORA,4,3,0,7
30,HIDALGOTITLAN,6,2,2,10
30,HUATUSCO,0,0,2,2
30,HUEYAPAN DE OCAMPO,9,7,5,21
30,IGNACIO DE LA LLAVE,0,1,1,2
30,IXCATEPEC,0,1,0,1
30,ISLA,23,31,30,84
30,IXHUACAN DE LOS REYES,0,0,2,2
30,IXHUATLAN DEL CAFE,1,0,0,1
30,IXHUATLAN DE MADERO,3,0,0,3
30,IXHUATLANCILLO,0,0,1,1
30,IXMATLAHUACAN,0,1,0,1
30,IXTACZOQUITLAN,2,0,5,7
30,JALACINGO,1,0,0,1
30,XALAPA,0,0,3,3
30,JALTIPAN,1,0,3,4
30,JAMAPA,0,0,1,1
30,JESUS CARRANZA,19,9,16,44
30,XICO,0,0,1,1
30,JUAN RODRIGUEZ CLARA,6,8,3,17
30,LERDO DE TEJADA,5,11,3,19
30,MANLIO FABIO ALTAMIRANO,0,0,3,3
30,MARTINEZ DE LA TORRE,16,24,7,47
30,MECAYAPAN,1,0,0,1
30,MEDELLIN,0,1,2,3
30,MINATITLAN,5,5,0,10
30,MISANTLA,2,0,0,2
30,NAUTLA,0,0,2,2
30,NOGALES,1,0,0,1
30,OLUTA,1,0,0,1
30,OMEALCA,7,6,0,13
30,ORIZABA,0,0,5,5
30,OTATITLAN,1,1,0,2
30,OZULUAMA DE MASCAREÑAS,2,1,26,29
30,PANUCO,40,41,34,115
30,PAPANTLA,25,3,5,33
30,PASO DEL MACHO,12,11,3,26
30,PEROTE,6,9,1,16
30,PLATON SANCHEZ,0,0,9,9
30,PLAYA VICENTE,6,4,4,14
30,POZA RICA DE HIDALGO,0,0,1,1
30,PUENTE NACIONAL,2,0,7,9
30,SAN ANDRES TUXTLA,13,4,2,19
30,SAN JUAN EVANGELISTA,7,21,4,32
30,SANTIAGO TUXTLA,0,2,2,4
30,SAYULA DE ALEMAN,3,9,3,15
30,SOCHIAPA,2,0,0,2
30,SOCONUSCO,0,0,1,1
30,SOLEDAD DE DOBLADO,5,1,0,6
30,SOTEAPAN,9,2,0,11
30,TAMALIN,1,0,1,2
30,TAMPICO ALTO,0,0,5,5
30,TANTIMA,0,1,1,2
30,TANTOYUCA,0,2,15,17
30,TATATILA,0,0,1,1
30,CASTILLO DE TEAYO,12,0,0,12
30,TEHUIPANGO,0,0,1,1
30,ALAMO TEMAPACHE,7,2,3,12
30,TEMPOAL,1,1,2,4
30,TEOCELO,0,0,8,8
30,TEQUILA,1,0,0,1
30,JOSE AZUETA,3,9,5,17
30,TEXISTEPEC,3,1,2,6
30,TEZONAPA,178,173,100,451
30,TIERRA BLANCA,1,8,37,46
30,TIHUATLAN,3,1,0,4
30,TLACOTALPAN,0,0,4,4
30,TRES VALLES,20,19,17,56
30,TLACOTEPEC DE MEJIA,0,1,0,1
30,TLALIXCOYAN,10,7,3,20
30,TLAPACOYAN,6,0,16,22
30,TUXPAN,3,1,3,7
30,URSULO GALVAN,237,22,11,270
30,VEGA DE ALATORRE,0,15,4,19
30,VERACRUZ,1,2,4,7
30,LAS VIGAS DE RAMIREZ,0,14,1,15
30,UXPANAPA,12,0,0,12
30,AGUA DULCE,1,1,1,3
30,ZONGOLICA,0,0,6,6
30,EL HIGO,11,16,15,42
30,CARLOS A. CARRILLO,0,1,1,2
30,SAN RAFAEL,5,6,1,12
31,ABALA,8,0,0,8
31,ACANCEH,0,1,0,1
31,BACA,1,1,0,2
31,BUCTZOTZ,1,0,0,1
31,CALOTMUL,2,0,0,2
31,CELESTUN,0,0,3,3
31,CENOTILLO,0,0,1,1
31,CHEMAX,1,0,0,1
31,CONKAL,1,0,0,1
31,DZEMUL,0,1,0,1
31,DZILAM GONZALEZ,3,0,0,3
31,DZONCAUICH,3,0,0,3
31,HOCTUN,1,0,0,1
31,HUNUCMA,0,1,0,1
31,IZAMAL,0,1,0,1
31,KANASIN,0,0,2,2
31,KINCHIL,0,0,1,1
31,MAXCANU,0,0,1,1
31,MERIDA,4,23,143,170
31,MOTUL,7,0,0,7
31,MUNA,2,1,0,3
31,OXKUTZCAB,0,2,7,9
31,PANABA,1,0,0,1
31,PETO,3,1,0,4
31,PROGRESO,14,19,38,71
31,RIO LAGARTOS,4,0,0,4
31,SAN FELIPE,6,1,7,14
31,SANTA ELENA,0,1,0,1
31,SEYE,0,0,2,2
31,SUCILA,3,0,0,3
31,TAHMEK,0,2,0,2
31,TEKAL DE VENEGAS,4,0,0,4
31,TEKAX,25,8,6,39
31,TEKIT,1,1,0,2
31,TECOH,0,0,1,1
31,TEMAX,2,1,0,3
31,TEMOZON,2,1,0,3
31,TEYA,0,0,1,1
31,TICUL,198,4,0,202
31,TIMUCUY,0,1,1,2
31,TIZIMIN,131,6,6,143
31,TUNKAS,1,0,0,1
31,TZUCACAB,1,2,0,3
31,UMAN,112,2,1,115
31,VALLADOLID,138,10,1,149
32,APOZOL,5,1,0,6
32,BENITO JUAREZ,4,3,2,9
32,CALERA,4,6,19,29
32,CAÑITAS DE FELIPE PESCADOR,3,0,0,3
32,CUAUHTEMOC,0,1,2,3
32,EL SALVADOR,0,1,0,1
32,FRESNILLO,61,43,72,176
32,TRINIDAD GARCIA DE LA CADENA,1,0,0,1
32,GENERAL ENRIQUE ESTRADA,0,0,2,2
32,GENERAL FRANCISCO R. MURGUIA,3,3,3,9
32,GENERAL PANFILO NATERA,1,0,8,9
32,GUADALUPE,3,5,5,13
32,JALPA,5,0,1,6
32,JEREZ,8,3,2,13
32,JUAN ALDAMA,7,4,9,20
32,LORETO,5,13,11,29
32,LUIS MOYA,0,2,1,3
32,MAZAPIL,0,0,2,2
32,MELCHOR OCAMPO,1,1,4,6
32,MIGUEL AUZA,24,44,8,76
32,MONTE ESCOBEDO,19,3,0,22
32,MORELOS,0,0,1,1
32,NOCHISTLAN DE MEJIA,1,0,0,1
32,NORIA DE ANGELES,6,0,1,7
32,OJOCALIENTE,5,11,7,23
32,PANUCO,6,2,8,16
32,PINOS,10,6,1,17
32,RIO GRANDE,20,13,24,57
32,SAIN ALTO,3,7,4,14
32,SOMBRERETE,17,29,16,62
32,TABASCO,0,0,3,3
32,TEPECHITLAN,0,3,2,5
32,TLALTENANGO DE SANCHEZ ROMAN,2,6,1,9
32,VALPARAISO,0,2,5,7
32,VETAGRANDE,2,0,3,5
32,VILLA DE COS,9,8,37,54
32,VILLA GARCIA,1,0,0,1
32,VILLA GONZALEZ ORTEGA,0,0,2,2
32,VILLA HIDALGO,11,4,0,15
32,VILLANUEVA,0,0,8,8
32,TRANCOSO,0,5,6,11
32,ZACATECAS,0,7,10,17
